ticker,q,positive_count,negative_count,polarity,sentiment
GDOT,2020-Q3,102,50,52,Positive
KAR,2020-Q2,96,83,13,Positive
HESM,2019-Q3,35,10,25,Positive
GNW,2020-Q4,99,109,-10,Negative
NET,2022-Q1,79,52,27,Positive
LZB,2021-Q3,101,68,33,Positive
DTM,2021-Q3,89,15,74,Positive
DFIN,2021-Q1,108,26,82,Positive
GOTU,2021-Q1,65,36,29,Positive
EL,2020-Q4,130,72,58,Positive
EBS,2020-Q4,65,74,-9,Negative
EAF,2021-Q1,83,39,44,Positive
HRB,2020-Q2,120,45,75,Positive
OTIS,2022-Q4,109,49,60,Positive
HLT,2020-Q1,59,89,-30,Negative
ADNT,2020-Q3,104,78,26,Positive
MKL,2022-Q3,118,127,-9,Negative
GNRC,2020-Q4,110,51,59,Positive
BABA,2021-Q3,102,56,46,Positive
MOD,2021-Q2,105,47,58,Positive
AI,2021-Q4,70,40,30,Positive
OTIS,2020-Q4,114,42,72,Positive
ONTO,2020-Q4,89,47,42,Positive
CLF,2020-Q4,89,42,47,Positive
APAM,2020-Q4,59,29,30,Positive
PRI,2021-Q1,61,58,3,Positive
ANET,2020-Q4,64,46,18,Positive
DIS,2020-Q3,126,81,45,Positive
MED,2020-Q4,86,29,57,Positive
DIS,2021-Q2,125,43,82,Positive
IHG,2020-Q4,105,60,45,Positive
AMWL,2021-Q1,78,31,47,Positive
IRS,2020-Q3,50,80,-30,Negative
CARS,2021-Q1,172,39,133,Positive
CACI,2020-Q2,106,36,70,Positive
HGV,2021-Q4,129,38,91,Positive
MAX,2021-Q3,45,34,11,Positive
CCO,2020-Q2,99,46,53,Positive
PLNT,2022-Q2,72,49,23,Positive
PFGC,2020-Q4,129,69,60,Positive
KMX,2020-Q1,106,54,52,Positive
NSA,2021-Q1,97,60,37,Positive
DOV,2021-Q1,120,39,81,Positive
LLY,2021-Q4,83,58,25,Positive
CBT,2020-Q3,90,67,23,Positive
NKE,2020-Q1,153,41,112,Positive
ACM,2021-Q4,159,25,134,Positive
PBR,2021-Q1,88,67,21,Positive
PINS,2020-Q4,153,45,108,Positive
PAG,2020-Q4,75,33,42,Positive
MODG,2022-Q3,126,49,77,Positive
KOS,2020-Q4,86,48,38,Positive
NOW,2020-Q1,115,55,60,Positive
OLO,2022-Q3,117,30,87,Positive
PLTR,2021-Q1,83,37,46,Positive
BOX,2021-Q4,138,32,106,Positive
BLND,2021-Q4,93,58,35,Positive
PINS,2022-Q4,115,40,75,Positive
MAIN,2021-Q1,93,32,61,Positive
RC,2021-Q2,66,36,30,Positive
FRO,2020-Q2,73,43,30,Positive
CHE,2021-Q2,76,69,7,Positive
MSM,2021-Q2,90,78,12,Positive
NET,2020-Q1,96,76,20,Positive
FSM,2020-Q3,57,51,6,Positive
CLX,2021-Q2,131,35,96,Positive
BFH,2020-Q1,105,107,-2,Negative
GTY,2020-Q4,89,27,62,Positive
CNA,2020-Q4,131,101,30,Positive
BUD,2020-Q4,135,53,82,Positive
ADM,2020-Q4,141,34,107,Positive
ANET,2022-Q2,83,48,35,Positive
GEF,2021-Q1,108,73,35,Positive
REX,2020-Q4,47,34,13,Positive
APO,2020-Q4,111,50,61,Positive
GEL,2020-Q4,54,38,16,Positive
GOTU,2021-Q2,40,29,11,Positive
HMC,2023-Q1,46,97,-51,Negative
BALL,2019-Q3,91,35,56,Positive
EEX,2019-Q3,130,58,72,Positive
PLTR,2021-Q3,86,31,55,Positive
HCA,2020-Q2,93,56,37,Positive
HRB,2020-Q1,126,55,71,Positive
GFI,2021-Q4,60,49,11,Positive
ONTF,2022-Q1,83,38,45,Positive
AAP,2021-Q1,129,30,99,Positive
MOD,2021-Q1,122,61,61,Positive
AIR,2021-Q1,90,58,32,Positive
GIS,2021-Q4,67,57,10,Positive
LOW,2021-Q1,166,28,138,Positive
OOMA,2021-Q2,116,42,74,Positive
ICL,2021-Q4,106,44,62,Positive
KMX,2021-Q3,101,38,63,Positive
MTZ,2020-Q4,104,39,65,Positive
COTY,2021-Q3,174,26,148,Positive
MSA,2019-Q2,112,56,56,Positive
NGVT,2021-Q4,110,48,62,Positive
ACEL,2021-Q2,91,34,57,Positive
DIS,2021-Q1,96,56,40,Positive
KTB,2020-Q3,168,39,129,Positive
MOD,2019-Q4,101,46,55,Positive
AMWL,2021-Q2,105,46,59,Positive
DIS,2020-Q3,126,81,45,Positive
MCD,2021-Q2,144,37,107,Positive
NIO,2021-Q1,75,67,8,Positive
MSA,2019-Q3,124,39,85,Positive
COTY,2021-Q2,164,40,124,Positive
KMX,2021-Q2,102,43,59,Positive
DOV,2021-Q2,112,65,47,Positive
AQN,2021-Q4,82,42,40,Positive
MKL,2020-Q4,100,102,-2,Negative
AR,2020-Q4,66,47,19,Positive
MTDR,2021-Q1,86,42,44,Positive
NKE,2020-Q2,172,19,153,Positive
OOMA,2020-Q3,94,42,52,Positive
MTH,2021-Q4,102,83,19,Positive
RKT,2021-Q4,108,48,60,Positive
HD,2021-Q1,118,44,74,Positive
DIS,2020-Q3,126,81,45,Positive
ALE,2021-Q2,97,32,65,Positive
PLTR,2021-Q2,99,40,59,Positive
EEX,2019-Q2,139,54,85,Positive
CVNA,2020-Q4,106,46,60,Positive
HNI,2021-Q1,114,29,85,Positive
GOTU,2021-Q2,40,29,11,Positive
RLX,2021-Q2,48,79,-31,Negative
IR,2021-Q4,144,28,116,Positive
KR,2022-Q1,121,29,92,Positive
KEY,2020-Q4,89,52,37,Positive
MSM,2021-Q1,102,69,33,Positive
AMBC,2019-Q3,55,67,-12,Negative
PLNT,2020-Q4,51,85,-34,Negative
AMRC,2020-Q4,83,38,45,Positive
FSM,2020-Q4,59,57,2,Positive
RDN,2019-Q4,59,60,-1,Negative
NVT,2020-Q4,134,42,92,Positive
ALV,2021-Q1,97,81,16,Positive
KMX,2023-Q3,103,55,48,Positive
EQNR,2020-Q4,124,60,64,Positive
CYH,2020-Q2,96,58,38,Positive
BALL,2021-Q2,103,40,63,Positive
ASR,2020-Q1,34,73,-39,Negative
HUBS,2019-Q3,83,58,25,Positive
GS,2020-Q3,103,56,47,Positive
MCD,2021-Q2,144,37,107,Positive
CXW,2019-Q3,80,57,23,Positive
MMM,2021-Q1,120,50,70,Positive
BAX,2020-Q4,92,65,27,Positive
FSLY,2020-Q2,124,41,83,Positive
NKE,2022-Q3,162,36,126,Positive
LCII,2021-Q1,155,36,119,Positive
CC,2020-Q3,106,57,49,Positive
OLO,2021-Q4,131,30,101,Positive
RITM,2022-Q3,81,53,28,Positive
AI,2022-Q2,93,35,58,Positive
CHCT,2021-Q1,39,35,4,Positive
LII,2020-Q4,85,37,48,Positive
HMC,2022-Q1,52,75,-23,Negative
ADM,2020-Q4,141,34,107,Positive
RGS,2022-Q1,38,27,11,Positive
MAX,2021-Q4,77,36,41,Positive
NTR,2021-Q1,124,45,79,Positive
CVS,2021-Q3,117,32,85,Positive
FRO,2020-Q2,73,43,30,Positive
IHG,2020-Q3,84,74,10,Positive
IIPR,2020-Q1,63,62,1,Positive
FSLY,2021-Q1,89,47,42,Positive
BJ,2022-Q1,127,42,85,Positive
IHG,2020-Q2,92,79,13,Positive
DT,2023-Q1,114,41,73,Positive
NET,2020-Q1,96,76,20,Positive
RF,2021-Q1,116,59,57,Positive
OIS,2020-Q4,116,58,58,Positive
AQN,2021-Q1,88,62,26,Positive
GL,2021-Q1,44,79,-35,Negative
BABA,2021-Q4,91,36,55,Positive
BNED,2020-Q1,129,28,101,Positive
RKT,2021-Q1,125,23,102,Positive
AZUL,2021-Q1,123,29,94,Positive
MTH,2021-Q1,118,60,58,Positive
RITM,2022-Q4,96,42,54,Positive
AI,2021-Q3,79,29,50,Positive
NKE,2023-Q2,178,45,133,Positive
CXW,2019-Q2,55,88,-33,Negative
MEI,2021-Q3,73,66,7,Positive
HNI,2020-Q4,125,41,84,Positive
IR,2021-Q1,103,49,54,Positive
CNS,2021-Q1,94,42,52,Positive
FTV,2020-Q1,61,97,-36,Negative
DIS,2020-Q3,126,81,45,Positive
BJ,2020-Q4,145,31,114,Positive
LZB,2021-Q4,123,61,62,Positive
CARR,2020-Q4,121,44,77,Positive
DT,2021-Q4,126,24,102,Positive
PFGC,2020-Q2,89,52,37,Positive
DIS,2020-Q3,126,81,45,Positive
MCD,2020-Q4,126,49,77,Positive
KMX,2023-Q2,94,73,21,Positive
HAL,2021-Q1,142,25,117,Positive
GFI,2021-Q4,60,49,11,Positive
GDOT,2020-Q4,108,55,53,Positive
GSK,2021-Q1,115,70,45,Positive
ALV,2021-Q2,89,92,-3,Negative
BALL,2021-Q1,102,41,61,Positive
DIS,2020-Q3,126,81,45,Positive
RC,2019-Q2,69,67,2,Positive
DIS,2020-Q3,126,81,45,Positive
MMM,2021-Q2,107,53,54,Positive
CBT,2022-Q3,108,42,66,Positive
DG,2021-Q1,142,46,96,Positive
CVEO,2021-Q4,56,59,-3,Negative
AI,2022-Q1,83,33,50,Positive
PDM,2021-Q3,117,25,92,Positive
ESI,2021-Q1,85,77,8,Positive
HMC,2021-Q2,53,94,-41,Negative
EIG,2021-Q2,58,94,-36,Negative
OOMA,2020-Q4,122,43,79,Positive
GBX,2019-Q4,131,50,81,Positive
GATX,2020-Q4,72,81,-9,Negative
CLF,2020-Q1,73,85,-12,Negative
CIM,2020-Q4,67,37,30,Positive
AROC,2021-Q2,70,40,30,Positive
G,2019-Q4,89,38,51,Positive
CMP,2020-Q4,113,77,36,Positive
PSTG,2021-Q4,149,34,115,Positive
IIPR,2022-Q3,81,62,19,Positive
KTB,2020-Q4,172,24,148,Positive
MAC,2020-Q4,52,67,-15,Negative
FOUR,2020-Q4,90,48,42,Positive
GLOB,2021-Q1,121,29,92,Positive
DT,2023-Q2,151,38,113,Positive
CVS,2022-Q1,104,39,65,Positive
RF,2021-Q2,112,52,60,Positive
ADM,2021-Q1,128,35,93,Positive
NVT,2022-Q3,140,44,96,Positive
GM,2020-Q4,131,43,88,Positive
LLY,2021-Q1,147,45,102,Positive
FCPT,2020-Q4,67,36,31,Positive
COMP,2021-Q3,88,39,49,Positive
DVA,2022-Q1,51,49,2,Positive
HMC,2021-Q3,60,87,-27,Negative
GIS,2021-Q3,75,60,15,Positive
OHI,2020-Q4,59,64,-5,Negative
CXW,2019-Q1,52,68,-16,Negative
GATX,2021-Q1,58,35,23,Positive
DVA,2020-Q4,41,65,-24,Negative
RLX,2021-Q4,70,58,12,Positive
IR,2021-Q2,112,31,81,Positive
RC,2019-Q3,80,64,16,Positive
NTST,2020-Q4,82,48,34,Positive
LRN,2020-Q1,79,52,27,Positive
CNR,2020-Q4,144,36,108,Positive
CNS,2021-Q2,96,32,64,Positive
OGE,2021-Q2,87,22,65,Positive
FOUR,2022-Q1,91,41,50,Positive
DIS,2023-Q1,137,47,90,Positive
MUR,2021-Q1,120,39,81,Positive
KMX,2023-Q1,129,65,64,Positive
HAL,2021-Q2,93,32,61,Positive
DIS,2020-Q3,126,81,45,Positive
PHR,2021-Q4,74,45,29,Positive
MDU,2019-Q2,60,49,11,Positive
FPI,2020-Q1,53,100,-47,Negative
DAC,2021-Q1,68,32,36,Positive
AI,2022-Q2,93,35,58,Positive
LAW,2022-Q1,102,70,32,Positive
GKOS,2020-Q4,120,49,71,Positive
PEN,2019-Q1,106,48,58,Positive
NX,2021-Q1,104,44,60,Positive
PRLB,2020-Q3,57,28,29,Positive
PFGC,2020-Q1,95,50,45,Positive
DBRG,2020-Q2,89,39,50,Positive
NRP,2020-Q2,30,67,-37,Negative
RMD,2021-Q2,108,42,66,Positive
JMIA,2020-Q4,123,52,71,Positive
COO,2021-Q4,118,56,62,Positive
HESM,2022-Q1,47,30,17,Positive
LOB,2021-Q4,117,17,100,Positive
LXP,2019-Q2,65,33,32,Positive
BDC,2020-Q4,99,52,47,Positive
MKC,2020-Q4,143,32,111,Positive
COMP,2021-Q3,88,39,49,Positive
RBLX,2022-Q1,92,42,50,Positive
EPAM,2022-Q4,66,58,8,Positive
AX,2020-Q1,66,45,21,Positive
AYI,2021-Q1,111,36,75,Positive
MKC,2022-Q2,88,102,-14,Negative
CTS,2020-Q1,94,75,19,Positive
PR,2019-Q3,64,38,26,Positive
IPI,2021-Q2,67,46,21,Positive
BEP,2020-Q4,101,30,71,Positive
ASIX,2019-Q3,64,65,-1,Negative
GES,2021-Q4,123,58,65,Positive
AGS,2021-Q1,143,41,102,Positive
AX,2019-Q4,93,43,50,Positive
MCK,2020-Q1,107,56,51,Positive
HCA,2021-Q2,73,45,28,Positive
EVRI,2020-Q4,112,43,69,Positive
MPLX,2020-Q4,80,42,38,Positive
RLX,2021-Q1,53,57,-4,Negative
LNC,2020-Q4,97,79,18,Positive
HBM,2021-Q2,75,48,27,Positive
CWT,2020-Q4,61,41,20,Positive
ALLY,2021-Q2,148,46,102,Positive
DBI,2021-Q4,112,28,84,Positive
ASIX,2019-Q2,73,80,-7,Negative
MDT,2022-Q4,87,82,5,Positive
PR,2019-Q2,77,38,39,Positive
DRH,2021-Q1,125,47,78,Positive
PARR,2019-Q2,69,54,15,Positive
LDI,2022-Q2,80,77,3,Positive
LBRT,2020-Q4,175,58,117,Positive
MODG,2021-Q1,111,37,74,Positive
COP,2021-Q4,85,33,52,Positive
PAR,2020-Q2,73,69,4,Positive
MDT,2020-Q1,114,53,61,Positive
HRI,2022-Q1,116,32,84,Positive
NPO,2021-Q1,128,52,76,Positive
LXP,2019-Q3,81,31,50,Positive
GMED,2020-Q4,101,67,34,Positive
NLY,2020-Q4,102,51,51,Positive
ESRT,2020-Q2,87,62,25,Positive
GLW,2021-Q1,151,34,117,Positive
RMD,2021-Q3,96,26,70,Positive
CWEN,2021-Q3,70,37,33,Positive
RS,2021-Q1,141,38,103,Positive
GEL,2021-Q4,52,27,25,Positive
CBZ,2019-Q3,94,35,59,Positive
CODI,2020-Q3,100,58,42,Positive
GTN,2021-Q1,84,42,42,Positive
RBA,2020-Q4,89,68,21,Positive
MCO,2021-Q1,108,41,67,Positive
OLO,2022-Q4,133,33,100,Positive
CHWY,2022-Q1,103,52,51,Positive
ARCO,2021-Q1,157,34,123,Positive
BFH,2020-Q2,81,94,-13,Negative
RM,2022-Q2,76,100,-24,Negative
ESTC,2021-Q3,136,39,97,Positive
CWEN,2021-Q1,71,39,32,Positive
AZEK,2021-Q1,119,41,78,Positive
RMD,2021-Q1,110,23,87,Positive
DKL,2020-Q4,30,18,12,Positive
LXP,2021-Q1,78,40,38,Positive
DIS,2019-Q4,97,51,46,Positive
FNV,2020-Q4,102,39,63,Positive
MTRN,2020-Q1,83,68,15,Positive
BCO,2020-Q1,66,91,-25,Negative
ADCT,2020-Q4,63,50,13,Positive
CHWY,2020-Q4,148,29,119,Positive
MSA,2020-Q1,100,63,37,Positive
HCA,2021-Q1,89,50,39,Positive
MFA,2021-Q1,90,87,3,Positive
MCK,2020-Q2,93,46,47,Positive
NVGS,2020-Q4,70,70,0,Neutral
HBM,2021-Q1,63,45,18,Positive
MOH,2020-Q4,72,77,-5,Negative
APG,2020-Q4,100,52,48,Positive
GHG,2020-Q2,71,59,12,Positive
AZO,2020-Q1,108,39,69,Positive
ALLY,2021-Q1,140,53,87,Positive
EPAM,2020-Q4,73,36,37,Positive
BRC,2022-Q1,108,63,45,Positive
LSPD,2021-Q3,91,54,37,Positive
ASR,2020-Q2,47,83,-36,Negative
BHE,2020-Q4,114,54,60,Positive
CUBE,2021-Q1,91,54,37,Positive
PMT,2021-Q3,36,49,-13,Negative
MODG,2021-Q2,106,47,59,Positive
HRI,2022-Q1,116,32,84,Positive
AHH,2021-Q1,60,53,7,Positive
MDT,2020-Q2,123,44,79,Positive
CE,2020-Q4,80,55,25,Positive
BEP,2022-Q3,108,41,67,Positive
FN,2020-Q1,85,36,49,Positive
ESRT,2020-Q1,57,74,-17,Negative
GLW,2021-Q2,127,33,94,Positive
IMAX,2022-Q1,111,22,89,Positive
DIS,2020-Q3,126,81,45,Positive
LMND,2020-Q4,99,71,28,Positive
DIS,2020-Q3,126,81,45,Positive
ASPN,2021-Q3,84,56,28,Positive
OKE,2021-Q3,62,29,33,Positive
CPB,2020-Q1,145,66,79,Positive
BFAM,2021-Q4,88,50,38,Positive
IDT,2022-Q2,67,61,6,Positive
GMS,2020-Q2,104,55,49,Positive
KR,2020-Q4,125,37,88,Positive
GCI,2021-Q1,80,34,46,Positive
MCK,2023-Q2,100,44,56,Positive
NOW,2020-Q4,153,31,122,Positive
NOV,2021-Q2,152,84,68,Positive
MED,2020-Q1,96,49,47,Positive
CRI,2020-Q4,158,84,74,Positive
LNN,2021-Q3,72,35,37,Positive
ECVT,2019-Q3,124,66,58,Positive
MTRN,2020-Q4,135,46,89,Positive
GBCI,2020-Q4,90,38,52,Positive
PFE,2021-Q1,75,44,31,Positive
AGS,2019-Q3,68,32,36,Positive
MTX,2021-Q3,100,34,66,Positive
BBY,2020-Q1,103,33,70,Positive
ELF,2021-Q3,107,24,83,Positive
BEP,2020-Q2,94,42,52,Positive
MA,2020-Q4,91,50,41,Positive
ASIX,2021-Q1,132,41,91,Positive
RVLV,2021-Q1,140,28,112,Positive
PR,2021-Q1,68,34,34,Positive
DRH,2019-Q2,112,49,63,Positive
PARR,2021-Q1,84,67,17,Positive
EPD,2021-Q1,69,42,27,Positive
ABBV,2022-Q1,124,43,81,Positive
NRG,2021-Q1,101,62,39,Positive
PRLB,2022-Q1,118,34,84,Positive
ARMK,2021-Q1,129,38,91,Positive
CABO,2020-Q4,88,55,33,Positive
DBI,2021-Q2,120,38,82,Positive
DRH,2019-Q3,105,60,45,Positive
IMAX,2021-Q2,101,34,67,Positive
ABEV,2022-Q1,106,51,55,Positive
MMC,2020-Q4,99,69,30,Positive
EVH,2021-Q1,117,38,79,Positive
CCI,2021-Q1,95,26,69,Positive
NET,2022-Q3,81,46,35,Positive
MMS,2019-Q3,101,48,53,Positive
KMPR,2020-Q4,118,69,49,Positive
RHP,2021-Q1,104,44,60,Positive
ABEV,2020-Q4,100,65,35,Positive
GNRC,2019-Q3,74,68,6,Positive
MDU,2021-Q1,69,46,23,Positive
EXP,2020-Q2,120,48,72,Positive
RH,2022-Q2,101,35,66,Positive
BBDC,2020-Q4,49,57,-8,Negative
PAR,2020-Q4,85,44,41,Positive
RS,2019-Q3,114,52,62,Positive
BDX,2021-Q1,120,36,84,Positive
ESRT,2020-Q4,89,55,34,Positive
KMPR,2022-Q1,96,62,34,Positive
CNC,2021-Q2,50,50,0,Neutral
IRT,2021-Q2,52,21,31,Positive
COO,2021-Q3,138,37,101,Positive
CFG,2021-Q1,127,29,98,Positive
PSX,2020-Q4,80,50,30,Positive
MCK,2022-Q3,108,40,68,Positive
ABBV,2020-Q4,104,41,63,Positive
DOC,2021-Q1,89,32,57,Positive
LXP,2021-Q1,78,40,38,Positive
GEL,2022-Q2,41,47,-6,Negative
DXC,2021-Q2,130,58,72,Positive
MPLX,2020-Q1,55,51,4,Positive
ENS,2020-Q2,68,60,8,Positive
AOS,2020-Q4,111,67,44,Positive
KBH,2019-Q2,103,37,66,Positive
HRI,2019-Q4,141,47,94,Positive
MTN,2021-Q2,96,47,49,Positive
NX,2021-Q4,75,71,4,Positive
LEVI,2020-Q3,129,34,95,Positive
COO,2021-Q1,130,30,100,Positive
PRU,2021-Q1,98,45,53,Positive
ELAN,2022-Q1,120,58,62,Positive
LOB,2021-Q1,76,48,28,Positive
CWAN,2022-Q1,110,42,68,Positive
NEU,2021-Q1,3,3,0,Neutral
BBY,2020-Q2,116,36,80,Positive
PMT,2021-Q4,40,41,-1,Negative
ASIX,2021-Q2,122,40,82,Positive
ELAN,2020-Q4,115,53,62,Positive
LSPD,2021-Q4,123,30,93,Positive
DV,2022-Q1,121,33,88,Positive
RH,2022-Q2,101,35,66,Positive
PR,2021-Q2,107,37,70,Positive
CCI,2020-Q2,63,34,29,Positive
IEX,2020-Q2,82,105,-23,Negative
PAYC,2020-Q4,87,38,49,Positive
ATO,2021-Q1,79,62,17,Positive
RH,2022-Q2,101,35,66,Positive
GHG,2021-Q4,56,90,-34,Negative
ARMK,2021-Q2,156,29,127,Positive
PRLB,2022-Q2,114,56,58,Positive
NRG,2021-Q2,118,38,80,Positive
IEX,2020-Q4,103,70,33,Positive
MITT,2021-Q3,69,31,38,Positive
NVGS,2020-Q3,69,59,10,Positive
HUM,2020-Q4,68,64,4,Positive
RBLX,2021-Q4,70,45,25,Positive
PBF,2022-Q2,71,66,5,Positive
IMAX,2021-Q1,121,41,80,Positive
LLY,2021-Q1,147,45,102,Positive
KSS,2021-Q1,157,34,123,Positive
BBY,2021-Q3,87,32,55,Positive
COP,2021-Q1,134,31,103,Positive
MTX,2021-Q1,116,28,88,Positive
LNN,2021-Q1,80,39,41,Positive
PBF,2020-Q4,84,68,16,Positive
BRBR,2020-Q3,113,57,56,Positive
BDX,2021-Q2,147,16,131,Positive
CFG,2021-Q2,138,33,105,Positive
CNC,2021-Q1,101,44,57,Positive
PEN,2021-Q1,85,51,34,Positive
ESTC,2021-Q4,136,53,83,Positive
PNW,2021-Q2,76,64,12,Positive
MTN,2021-Q3,101,45,56,Positive
CTVA,2021-Q1,132,44,88,Positive
OKE,2021-Q1,73,37,36,Positive
KBH,2019-Q3,107,27,80,Positive
AHH,2019-Q3,93,32,61,Positive
DXC,2020-Q1,77,50,27,Positive
CUBI,2021-Q1,98,28,70,Positive
OLO,2022-Q3,117,30,87,Positive
MTH,2020-Q4,109,78,31,Positive
RKT,2020-Q4,124,34,90,Positive
FRO,2022-Q1,60,71,-11,Negative
MMS,2021-Q2,107,48,59,Positive
OLO,2021-Q1,102,19,83,Positive
GBX,2019-Q3,126,45,81,Positive
AQN,2020-Q4,86,60,26,Positive
RF,2020-Q4,114,56,58,Positive
CIM,2021-Q3,75,33,42,Positive
FSLY,2020-Q4,95,57,38,Positive
GSK,2020-Q4,138,61,77,Positive
MGY,2021-Q3,83,57,26,Positive
ESTC,2020-Q4,123,61,62,Positive
CLX,2020-Q1,147,69,78,Positive
GNL,2020-Q4,70,54,16,Positive
GFI,2021-Q4,60,49,11,Positive
EAT,2021-Q2,99,43,56,Positive
MCD,2021-Q1,133,49,84,Positive
MAIN,2020-Q2,99,39,60,Positive
CARR,2021-Q1,121,40,81,Positive
BJ,2021-Q1,150,36,114,Positive
CNS,2020-Q4,111,76,35,Positive
RBLX,2021-Q3,68,55,13,Positive
IR,2020-Q4,115,35,80,Positive
HNI,2021-Q1,114,29,85,Positive
BILL,2021-Q2,118,31,87,Positive
ACI,2021-Q4,101,36,65,Positive
BAX,2021-Q1,83,62,21,Positive
EVTC,2019-Q3,65,58,7,Positive
MMM,2020-Q4,138,48,90,Positive
BXMT,2020-Q1,68,82,-14,Negative
HCA,2020-Q2,93,56,37,Positive
MTW,2020-Q4,105,54,51,Positive
RITM,2022-Q3,81,53,28,Positive
EQNR,2021-Q1,92,66,26,Positive
EAT,2021-Q3,114,43,71,Positive
ALV,2020-Q4,101,73,28,Positive
NVT,2021-Q1,166,33,133,Positive
RDN,2021-Q3,86,90,-4,Negative
BAP,2020-Q4,58,68,-10,Negative
IIPR,2021-Q4,50,32,18,Positive
NPO,2020-Q4,126,60,66,Positive
ICL,2020-Q4,115,63,52,Positive
NNN,2019-Q2,71,40,31,Positive
NTR,2020-Q4,116,38,78,Positive
GATX,2021-Q2,100,59,41,Positive
NKE,2021-Q3,156,61,95,Positive
EIG,2020-Q4,79,110,-31,Negative
PINS,2021-Q1,94,39,55,Positive
ADM,2021-Q1,128,35,93,Positive
MOD,2020-Q1,46,59,-13,Negative
HMC,2020-Q4,74,104,-30,Negative
LII,2021-Q1,98,37,61,Positive
HLT,2019-Q4,110,58,52,Positive
PBR,2020-Q3,87,79,8,Positive
EXR,2020-Q4,84,71,13,Positive
BABA,2020-Q2,113,33,80,Positive
MOD,2020-Q3,108,78,30,Positive
MMM,2022-Q3,105,75,30,Positive
FCPT,2021-Q1,75,38,37,Positive
MMS,2021-Q1,79,68,11,Positive
LLY,2020-Q4,105,42,63,Positive
CBT,2021-Q3,100,53,47,Positive
GM,2021-Q1,143,49,94,Positive
ADM,2020-Q4,141,34,107,Positive
COTY,2020-Q1,141,61,80,Positive
KN,2019-Q2,92,35,57,Positive
NOMD,2021-Q1,126,32,94,Positive
CX,2020-Q4,119,75,44,Positive
MUR,2022-Q1,100,37,63,Positive
MAC,2021-Q1,71,40,31,Positive
HGV,2020-Q4,111,61,50,Positive
DOC,2020-Q2,99,48,51,Positive
MGY,2021-Q3,83,57,26,Positive
CSTM,2021-Q2,107,40,67,Positive
MUR,2020-Q4,81,46,35,Positive
CARS,2020-Q4,137,31,106,Positive
LAZ,2020-Q4,86,63,23,Positive
BJ,2021-Q2,156,32,124,Positive
AZZ,2021-Q4,94,71,23,Positive
HRB,2021-Q3,100,53,47,Positive
ACM,2022-Q1,147,44,103,Positive
REX,2019-Q2,32,67,-35,Negative
ELV,2022-Q2,117,50,67,Positive
CPNG,2022-Q2,164,73,91,Positive
DVA,2021-Q1,57,67,-10,Negative
OHI,2021-Q1,45,59,-14,Negative
DG,2020-Q4,125,34,91,Positive
EL,2021-Q2,150,48,102,Positive
RGS,2021-Q2,61,65,-4,Negative
MAIN,2019-Q3,55,34,21,Positive
DIS,2020-Q3,126,81,45,Positive
REX,2019-Q3,46,62,-16,Negative
EBR,2020-Q2,38,46,-8,Negative
CMRE,2021-Q3,33,23,10,Positive
HRB,2021-Q2,124,36,88,Positive
ADM,2019-Q3,110,50,60,Positive
PHX,2020-Q3,17,24,-7,Negative
RIO,2020-Q4,151,65,86,Positive
DIS,2020-Q3,126,81,45,Positive
BALL,2020-Q4,107,31,76,Positive
DIS,2020-Q3,126,81,45,Positive
GFI,2021-Q4,60,49,11,Positive
NOW,2019-Q4,137,37,100,Positive
RDN,2021-Q3,86,90,-4,Negative
ACEL,2020-Q2,34,65,-31,Negative
HE,2021-Q3,91,42,49,Positive
DIS,2020-Q2,97,112,-15,Negative
JELD,2021-Q1,172,28,144,Positive
CIM,2021-Q1,28,26,2,Positive
GATX,2021-Q1,58,35,23,Positive
KN,2019-Q3,76,51,25,Positive
MMS,2019-Q4,103,41,62,Positive
GBX,2021-Q1,118,71,47,Positive
CBT,2021-Q2,115,39,76,Positive
PAR,2021-Q4,95,39,56,Positive
PINS,2021-Q2,65,45,20,Positive
DIS,2020-Q3,126,81,45,Positive
BABA,2020-Q3,100,85,15,Positive
MOD,2020-Q2,85,97,-12,Negative
KOS,2021-Q1,100,29,71,Positive
AZUL,2020-Q2,101,45,56,Positive
PAGS,2021-Q1,97,50,47,Positive
RPM,2021-Q2,118,57,61,Positive
PBR,2021-Q3,87,72,15,Positive
NKE,2021-Q4,158,38,120,Positive
GBX,2021-Q1,118,71,47,Positive
LLY,2020-Q1,83,60,23,Positive
FIGS,2021-Q4,156,33,123,Positive
NSA,2020-Q4,85,57,28,Positive
GHM,2021-Q3,74,55,19,Positive
REVG,2022-Q2,59,80,-21,Negative
CC,2021-Q3,117,45,72,Positive
IIPR,2022-Q3,81,62,19,Positive
MSM,2022-Q2,97,55,42,Positive
CARS,2020-Q4,137,31,106,Positive
OVV,2021-Q1,157,50,107,Positive
AMWL,2020-Q4,74,39,35,Positive
GFL,2021-Q2,86,43,43,Positive
PDS,2020-Q1,81,86,-5,Negative
PLNT,2021-Q2,69,64,5,Positive
RH,2022-Q2,101,35,66,Positive
RH,2021-Q4,75,48,27,Positive
PSTG,2022-Q1,101,36,65,Positive
BAK,2021-Q1,55,44,11,Positive
ITGR,2019-Q2,88,38,50,Positive
HNI,2019-Q3,64,45,19,Positive
MAIN,2020-Q4,102,41,61,Positive
BWXT,2022-Q1,90,56,34,Positive
AVNT,2021-Q1,98,50,48,Positive
ALE,2020-Q4,117,32,85,Positive
GFI,2021-Q2,100,58,42,Positive
HUBS,2020-Q4,116,35,81,Positive
LOW,2022-Q2,146,42,104,Positive
EBS,2021-Q1,76,67,9,Positive
JHX,2021-Q4,155,27,128,Positive
MTW,2020-Q2,97,81,16,Positive
DFIN,2020-Q4,109,22,87,Positive
KMT,2021-Q3,109,69,40,Positive
GOTU,2020-Q4,89,39,50,Positive
RMD,2020-Q3,105,42,63,Positive
ITGR,2019-Q3,117,49,68,Positive
BHC,2021-Q2,114,59,55,Positive
LRN,2019-Q4,65,23,42,Positive
GNW,2021-Q1,103,84,19,Positive
EVTC,2021-Q1,89,29,60,Positive
GTY,2021-Q2,57,26,31,Positive
CXW,2020-Q4,80,87,-7,Negative
GFL,2021-Q3,89,43,46,Positive
ANET,2021-Q1,64,43,21,Positive
APAM,2021-Q1,58,38,20,Positive
GBX,2019-Q4,131,50,81,Positive
PBA,2020-Q2,71,49,22,Positive
AQN,2020-Q3,120,51,69,Positive
CLF,2021-Q1,83,53,30,Positive
MTZ,2021-Q2,112,37,75,Positive
ONTO,2021-Q1,105,40,65,Positive
ONTF,2021-Q2,64,21,43,Positive
FTI,2020-Q4,113,33,80,Positive
HUBS,2022-Q1,110,44,66,Positive
CVEO,2020-Q4,50,63,-13,Negative
DIS,2020-Q3,126,81,45,Positive
GNRC,2021-Q1,125,36,89,Positive
PAG,2021-Q2,74,35,39,Positive
RH,2021-Q4,75,48,27,Positive
ATO,2020-Q2,43,55,-12,Negative
HAYW,2022-Q2,90,46,44,Positive
GATX,2019-Q2,94,54,40,Positive
GTN,2020-Q2,91,68,23,Positive
GL,2020-Q1,55,101,-46,Negative
MKL,2021-Q1,113,79,34,Positive
LCII,2020-Q4,126,54,72,Positive
REVG,2022-Q1,93,74,19,Positive
APAM,2021-Q3,72,33,39,Positive
MMS,2019-Q3,101,48,53,Positive
LZB,2022-Q1,82,58,24,Positive
CACI,2021-Q2,95,50,45,Positive
KODK,2020-Q4,35,39,-4,Negative
NIO,2020-Q4,90,53,37,Positive
MSM,2023-Q1,90,39,51,Positive
ANET,2021-Q3,62,47,15,Positive
ECVT,2020-Q1,96,88,8,Positive
AMRC,2021-Q1,137,47,90,Positive
PLNT,2021-Q1,55,54,1,Positive
BXP,2020-Q4,64,47,17,Positive
NOW,2019-Q3,132,43,89,Positive
NET,2022-Q1,79,52,27,Positive
BC,2019-Q3,141,42,99,Positive
BWXT,2022-Q2,99,53,46,Positive
KEY,2021-Q1,94,42,52,Positive
BALL,2020-Q3,89,60,29,Positive
BAK,2021-Q2,79,51,28,Positive
DIS,2020-Q3,126,81,45,Positive
EBS,2021-Q3,92,63,29,Positive
BOX,2020-Q2,152,50,102,Positive
DIS,2020-Q3,126,81,45,Positive
AVNT,2021-Q2,86,54,32,Positive
HD,2020-Q4,109,37,72,Positive
AMRC,2020-Q4,83,38,45,Positive
FNB,2020-Q1,65,68,-3,Negative
GM,2020-Q1,86,76,10,Positive
HE,2021-Q3,91,42,49,Positive
AGO,2020-Q2,99,83,16,Positive
ATR,2021-Q1,57,46,11,Positive
AMH,2021-Q1,116,48,68,Positive
HRB,2021-Q4,110,41,69,Positive
APO,2021-Q1,96,32,64,Positive
GM,2021-Q1,143,49,94,Positive
BHC,2021-Q3,86,70,16,Positive
REX,2021-Q1,63,34,29,Positive
BALL,2021-Q2,103,40,63,Positive
INN,2019-Q3,95,48,47,Positive
BWXT,2021-Q3,80,52,28,Positive
BC,2019-Q2,109,47,62,Positive
BUD,2021-Q1,111,41,70,Positive
AZZ,2022-Q3,89,43,46,Positive
LTC,2020-Q4,55,56,-1,Negative
CPS,2020-Q4,102,72,30,Positive
APG,2022-Q2,132,51,81,Positive
GEF,2022-Q1,99,71,28,Positive
MED,2021-Q2,80,20,60,Positive
ANET,2021-Q2,78,50,28,Positive
IIPR,2022-Q1,54,27,27,Positive
CACI,2021-Q3,104,50,54,Positive
CC,2021-Q1,117,49,68,Positive
COR,2021-Q1,98,51,47,Positive
MAX,2020-Q4,55,33,22,Positive
NWG,2022-Q1,84,43,41,Positive
CLF,2021-Q2,109,57,52,Positive
MTZ,2021-Q1,124,23,101,Positive
EBS,2020-Q1,83,55,28,Positive
GBX,2021-Q3,123,51,72,Positive
DIS,2020-Q3,126,81,45,Positive
GATX,2019-Q3,76,46,30,Positive
LOW,2020-Q4,147,31,116,Positive
OTIS,2021-Q2,116,37,79,Positive
GIS,2021-Q1,63,54,9,Positive
GNRC,2021-Q2,121,33,88,Positive
MOD,2020-Q4,84,90,-6,Negative
PINS,2022-Q3,102,24,78,Positive
DIS,2023-Q1,137,47,90,Positive
RAMP,2022-Q1,167,30,137,Positive
CFG,2022-Q1,151,41,110,Positive
MPW,2019-Q2,59,45,14,Positive
CWT,2019-Q3,35,53,-18,Negative
AX,2021-Q3,86,51,35,Positive
GSK,2020-Q3,157,46,111,Positive
GPK,2019-Q3,85,46,39,Positive
DRH,2020-Q2,111,69,42,Positive
MEG,2021-Q2,83,34,49,Positive
EVH,2020-Q4,134,31,103,Positive
CCI,2020-Q4,91,45,46,Positive
MMC,2021-Q1,132,46,86,Positive
BRBR,2020-Q1,122,44,78,Positive
DXC,2023-Q2,75,68,7,Positive
CABO,2021-Q1,53,39,14,Positive
BBY,2020-Q1,103,33,70,Positive
PAYC,2021-Q3,127,31,96,Positive
HASI,2020-Q4,95,45,50,Positive
MCK,2021-Q3,84,40,44,Positive
RELX,2021-Q2,139,64,75,Positive
NRG,2020-Q4,72,50,22,Positive
LMND,2021-Q4,83,113,-30,Negative
CSL,2021-Q2,117,57,60,Positive
PRLB,2021-Q1,89,39,50,Positive
ALV,2021-Q1,97,81,16,Positive
ABBV,2021-Q1,100,38,62,Positive
CFG,2020-Q4,120,42,78,Positive
PSX,2021-Q1,86,59,27,Positive
ESRT,2021-Q1,80,33,47,Positive
PAR,2021-Q1,90,44,46,Positive
KSS,2022-Q2,106,62,44,Positive
EVH,2022-Q1,126,22,104,Positive
PBF,2021-Q2,71,48,23,Positive
IMAX,2022-Q2,95,54,41,Positive
ABEV,2021-Q1,107,56,51,Positive
PSX,2020-Q2,53,70,-17,Negative
MDT,2021-Q3,162,49,113,Positive
CRI,2021-Q1,160,51,109,Positive
LEVI,2021-Q2,122,26,96,Positive
NOW,2021-Q1,138,40,98,Positive
PFE,2022-Q4,118,33,85,Positive
EPD,2022-Q1,55,56,-1,Negative
KR,2021-Q1,112,40,72,Positive
MITT,2022-Q1,62,49,13,Positive
BFAM,2022-Q1,106,30,76,Positive
KBH,2019-Q4,124,30,94,Positive
GES,2022-Q2,123,44,79,Positive
FN,2019-Q4,74,47,27,Positive
CNNE,2020-Q4,42,35,7,Positive
ENS,2021-Q4,91,52,39,Positive
RELX,2020-Q4,93,70,23,Positive
EPD,2020-Q4,54,45,9,Positive
MITT,2020-Q4,31,25,6,Positive
IDT,2021-Q2,65,36,29,Positive
KR,2021-Q1,112,40,72,Positive
PHR,2022-Q2,90,43,47,Positive
PBR,2020-Q3,87,79,8,Positive
OLO,2022-Q4,133,33,100,Positive
RVLV,2020-Q4,165,37,128,Positive
ASIX,2020-Q4,127,45,82,Positive
CODI,2022-Q2,88,40,48,Positive
MA,2021-Q1,119,32,87,Positive
EVRI,2019-Q3,114,15,99,Positive
MPW,2019-Q3,89,39,50,Positive
DIS,2020-Q3,126,81,45,Positive
AX,2021-Q2,68,64,4,Positive
PFE,2020-Q4,109,47,62,Positive
GDDY,2020-Q3,113,40,73,Positive
CNC,2022-Q1,151,38,113,Positive
EL,2020-Q2,144,60,84,Positive
CIO,2020-Q2,48,34,14,Positive
MTX,2020-Q4,138,39,99,Positive
MPW,2019-Q4,100,35,65,Positive
COP,2020-Q4,84,60,24,Positive
DEI,2020-Q4,66,76,-10,Negative
NGL,2021-Q1,41,50,-9,Negative
KSS,2020-Q4,173,23,150,Positive
LLY,2020-Q4,105,42,63,Positive
GTES,2019-Q3,100,100,0,Neutral
IMAX,2020-Q4,122,48,74,Positive
MMC,2021-Q2,131,60,71,Positive
ADT,2020-Q4,149,47,102,Positive
EL,2021-Q3,151,46,105,Positive
CABO,2021-Q2,72,27,45,Positive
HUM,2021-Q1,105,42,63,Positive
BRC,2022-Q1,108,63,45,Positive
DBI,2020-Q4,108,57,51,Positive
OKE,2022-Q1,78,45,33,Positive
DEA,2021-Q1,92,29,63,Positive
GPK,2021-Q4,89,15,74,Positive
DIS,2020-Q3,126,81,45,Positive
RELX,2020-Q1,52,98,-46,Negative
BHE,2019-Q3,77,33,44,Positive
CUBI,2020-Q4,85,28,57,Positive
DXC,2021-Q4,119,63,56,Positive
PNNT,2022-Q3,54,63,-9,Negative
OKE,2020-Q4,89,46,43,Positive
CTVA,2020-Q4,157,41,116,Positive
ABBV,2021-Q2,117,32,85,Positive
PEN,2020-Q4,79,67,12,Positive
CNC,2020-Q4,89,46,43,Positive
GGG,2020-Q1,70,97,-27,Negative
NOW,2021-Q3,115,42,73,Positive
BFH,2019-Q4,73,60,13,Positive
ELF,2022-Q1,130,47,83,Positive
BBDC,2021-Q2,75,56,19,Positive
MWA,2019-Q3,87,46,41,Positive
ABEV,2021-Q2,99,44,55,Positive
PBF,2021-Q1,60,63,-3,Negative
LOB,2020-Q4,80,31,49,Positive
RBA,2019-Q3,115,37,78,Positive
PRU,2020-Q4,90,50,40,Positive
LEVI,2021-Q2,122,26,96,Positive
PRLB,2021-Q3,90,53,37,Positive
GM,2021-Q4,104,27,77,Positive
ADCT,2021-Q1,42,46,-4,Negative
DAC,2021-Q1,68,32,36,Positive
BFAM,2022-Q2,59,52,7,Positive
BUD,2021-Q1,111,41,70,Positive
RH,2021-Q2,74,56,18,Positive
AOS,2021-Q1,95,53,42,Positive
BHE,2019-Q2,102,42,60,Positive
PAYC,2021-Q1,98,37,61,Positive
MYE,2021-Q2,99,45,54,Positive
EL,2021-Q2,150,48,102,Positive
DNOW,2021-Q2,76,39,37,Positive
GTES,2019-Q2,74,103,-29,Negative
GRBK,2021-Q1,81,66,15,Positive
PMT,2021-Q1,43,47,-4,Negative
AWR,2020-Q4,55,44,11,Positive
NEU,2020-Q4,15,3,12,Positive
ARLO,2022-Q2,72,29,43,Positive
HESM,2021-Q4,38,14,24,Positive
DIS,2020-Q3,126,81,45,Positive
CMI,2021-Q1,108,52,56,Positive
GLW,2022-Q1,141,30,111,Positive
MODG,2020-Q4,108,61,47,Positive
NVST,2020-Q4,110,37,73,Positive
OTIS,2021-Q3,102,57,45,Positive
DRH,2020-Q4,123,53,70,Positive
CCI,2020-Q2,63,34,29,Positive
CABO,2019-Q3,61,29,32,Positive
CHWY,2021-Q3,111,58,53,Positive
CWT,2021-Q1,42,65,-23,Negative
LNC,2021-Q1,143,67,76,Positive
AMCR,2021-Q3,94,59,35,Positive
NRG,2021-Q2,118,38,80,Positive
RM,2021-Q3,100,56,44,Positive
GBCI,2019-Q2,91,30,61,Positive
KUKE,2022-Q1,38,50,-12,Negative
MPLX,2021-Q1,72,38,34,Positive
RNG,2021-Q1,139,36,103,Positive
NVGS,2021-Q4,49,57,-8,Negative
CPB,2021-Q3,94,74,20,Positive
LHX,2020-Q4,94,48,46,Positive
CNNE,2021-Q3,44,20,24,Positive
ENS,2021-Q3,97,45,52,Positive
PSX,2021-Q2,79,39,40,Positive
RS,2020-Q4,124,70,54,Positive
DD,2020-Q4,124,56,68,Positive
GLW,2020-Q4,135,54,81,Positive
BRBR,2021-Q3,92,70,22,Positive
GDDY,2022-Q1,114,36,78,Positive
GGG,2020-Q4,93,46,47,Positive
NLY,2021-Q1,92,60,32,Positive
GMED,2021-Q1,97,45,52,Positive
APD,2020-Q2,104,85,19,Positive
NPO,2020-Q4,126,60,66,Positive
BFAM,2019-Q2,90,18,72,Positive
MDT,2021-Q4,138,39,99,Positive
CE,2021-Q2,50,67,-17,Negative
LOB,2020-Q1,64,61,3,Positive
JMIA,2021-Q1,99,26,73,Positive
GKOS,2021-Q1,112,37,75,Positive
LCII,2021-Q3,110,45,65,Positive
MA,2022-Q3,86,30,56,Positive
CPB,2021-Q2,146,53,93,Positive
ASPN,2020-Q4,89,53,36,Positive
CNNE,2020-Q2,55,37,18,Positive
ADCT,2021-Q4,86,62,24,Positive
CWEN,2022-Q2,79,49,30,Positive
MITT,2020-Q2,21,32,-11,Negative
ORI,2021-Q3,79,45,34,Positive
GBCI,2019-Q3,95,60,35,Positive
DIS,2020-Q3,126,81,45,Positive
MCK,2021-Q4,80,41,39,Positive
MPW,2021-Q1,75,38,37,Positive
AGS,2020-Q2,92,53,39,Positive
AMCR,2021-Q2,132,39,93,Positive
BEP,2021-Q1,95,30,65,Positive
AYI,2020-Q1,160,51,109,Positive
CCI,2021-Q3,79,30,49,Positive
G,2020-Q1,75,65,10,Positive
BRX,2019-Q3,88,52,36,Positive
CPB,2020-Q1,145,66,79,Positive
DIS,2020-Q3,126,81,45,Positive
DIS,2020-Q3,126,81,45,Positive
BHE,2021-Q1,106,44,62,Positive
RAMP,2021-Q4,112,48,64,Positive
CULP,2020-Q2,142,52,90,Positive
EPAM,2021-Q1,83,33,50,Positive
CODI,2019-Q3,101,54,47,Positive
ALLY,2020-Q4,137,69,68,Positive
POST,2020-Q3,90,84,6,Positive
ATO,2020-Q3,69,60,9,Positive
NRG,2020-Q1,73,47,26,Positive
RNG,2021-Q2,177,30,147,Positive
DIN,2019-Q2,153,39,114,Positive
LMND,2021-Q1,80,110,-30,Negative
INSW,2020-Q2,73,45,28,Positive
BCC,2021-Q3,73,63,10,Positive
CWK,2021-Q3,112,33,79,Positive
GMS,2021-Q3,112,67,45,Positive
CSL,2019-Q3,142,58,84,Positive
BFH,2019-Q2,96,54,42,Positive
PSX,2021-Q4,101,27,74,Positive
ESRT,2021-Q4,88,42,46,Positive
GMED,2021-Q2,77,60,17,Positive
PAR,2021-Q4,95,39,56,Positive
CE,2021-Q1,60,68,-8,Negative
BBU,2019-Q2,90,52,38,Positive
HRI,2020-Q4,116,69,47,Positive
MWA,2019-Q4,93,51,42,Positive
IPI,2022-Q1,55,53,2,Positive
BBU,2019-Q3,66,40,26,Positive
MUSA,2020-Q4,109,32,77,Positive
MKC,2021-Q2,122,48,74,Positive
FBK,2020-Q1,76,70,6,Positive
BFH,2019-Q3,91,74,17,Positive
MODG,2020-Q2,88,61,27,Positive
DKL,2021-Q1,35,15,20,Positive
CSL,2019-Q2,124,68,56,Positive
M,2022-Q2,120,64,56,Positive
CWEN,2020-Q4,52,39,13,Positive
DIS,2020-Q3,126,81,45,Positive
MCO,2019-Q3,99,54,45,Positive
MCK,2023-Q2,100,44,56,Positive
PK,2020-Q4,105,87,18,Positive
ENS,2021-Q1,100,71,29,Positive
CYH,2020-Q2,96,58,38,Positive
DXC,2021-Q3,158,54,104,Positive
DIN,2019-Q3,162,52,110,Positive
IIIN,2019-Q4,52,61,-9,Negative
GTN,2020-Q4,74,65,9,Positive
RNG,2021-Q3,144,31,113,Positive
IR,2020-Q4,115,35,80,Positive
IEX,2021-Q1,105,55,50,Positive
HCA,2020-Q4,104,44,60,Positive
MFA,2020-Q4,67,94,-27,Negative
GNRC,2021-Q1,125,36,89,Positive
CHWY,2022-Q1,103,52,51,Positive
NOW,2019-Q3,132,43,89,Positive
GRBK,2019-Q3,53,24,29,Positive
EL,2021-Q4,160,50,110,Positive
IPI,2020-Q4,102,39,63,Positive
MUSA,2022-Q1,131,49,82,Positive
ARLO,2021-Q4,85,22,63,Positive
ORI,2020-Q1,70,92,-22,Negative
FNV,2021-Q1,93,31,62,Positive
JHX,2020-Q3,128,23,105,Positive
BILL,2020-Q2,93,34,59,Positive
POST,2021-Q2,84,87,-3,Negative
OVV,2020-Q4,126,44,82,Positive
DEA,2020-Q1,74,23,51,Positive
GTES,2020-Q4,135,51,84,Positive
AGS,2020-Q3,110,24,86,Positive
CBT,2020-Q4,109,43,66,Positive
FNB,2021-Q2,128,55,73,Positive
AHH,2020-Q4,64,47,17,Positive
INSP,2020-Q1,89,52,37,Positive
HAYW,2021-Q1,135,22,113,Positive
NSP,2020-Q4,108,57,51,Positive
IIIN,2021-Q1,85,55,30,Positive
CBZ,2020-Q3,102,62,40,Positive
EPRT,2020-Q3,68,72,-4,Negative
ATR,2020-Q4,103,63,40,Positive
ORI,2021-Q1,92,58,34,Positive
CVNA,2020-Q3,120,29,91,Positive
FBK,2020-Q3,96,52,44,Positive
GIB,2020-Q4,106,53,53,Positive
CPRI,2021-Q1,115,64,51,Positive
BDC,2019-Q4,79,47,32,Positive
NI,2020-Q1,58,65,-7,Negative
EVRI,2019-Q2,97,25,72,Positive
PFS,2021-Q1,96,45,51,Positive
FNB,2021-Q1,136,29,107,Positive
CBZ,2020-Q1,92,70,22,Positive
AVA,2021-Q1,36,21,15,Positive
AM,2020-Q1,66,45,21,Positive
PARR,2020-Q4,98,58,40,Positive
PEB,2020-Q3,144,92,52,Positive
ACM,2019-Q3,108,50,58,Positive
EVRI,2020-Q2,108,33,75,Positive
ASB,2020-Q4,93,52,41,Positive
MEI,2020-Q4,96,60,36,Positive
AGRO,2020-Q2,76,56,20,Positive
OMF,2021-Q1,117,58,59,Positive
MFC,2020-Q2,120,86,34,Positive
GFL,2021-Q1,113,58,55,Positive
EAF,2020-Q4,85,29,56,Positive
OMF,2020-Q3,110,93,17,Positive
PEB,2021-Q1,143,48,95,Positive
RDN,2019-Q3,76,78,-2,Negative
BV,2021-Q2,119,42,77,Positive
CHMI,2020-Q3,46,39,7,Positive
HESM,2020-Q2,59,26,33,Positive
ELAN,2020-Q1,106,71,35,Positive
DX,2020-Q2,47,64,-17,Negative
KN,2020-Q4,72,58,14,Positive
ASB,2020-Q3,57,63,-6,Negative
GRBK,2019-Q4,76,42,34,Positive
NFG,2021-Q2,79,35,44,Positive
RC,2020-Q4,83,59,24,Positive
REVG,2020-Q4,127,64,63,Positive
FIX,2020-Q2,124,57,67,Positive
RSG,2020-Q4,124,37,87,Positive
CAL,2020-Q2,109,76,33,Positive
MITT,2021-Q1,80,20,60,Positive
GCI,2019-Q3,77,38,39,Positive
OFG,2021-Q2,66,44,22,Positive
CHE,2020-Q3,70,60,10,Positive
NOMD,2020-Q1,90,59,31,Positive
PUMP,2021-Q1,119,63,56,Positive
AMN,2020-Q2,82,58,24,Positive
CSL,2021-Q1,138,57,81,Positive
RNR,2021-Q2,148,53,95,Positive
AVA,2020-Q3,50,53,-3,Negative
IHG,2021-Q1,84,50,34,Positive
CXW,2021-Q1,77,88,-11,Negative
RHP,2020-Q4,95,58,37,Positive
AZO,2021-Q2,102,55,47,Positive
KAR,2020-Q2,96,83,13,Positive
KREF,2019-Q3,71,57,14,Positive
KMT,2021-Q2,115,74,41,Positive
KMPR,2021-Q1,68,96,-28,Negative
GWRE,2021-Q1,111,53,58,Positive
PHR,2021-Q3,79,29,50,Positive
GRBK,2020-Q1,71,67,4,Positive
BANC,2020-Q4,136,40,96,Positive
GIB,2020-Q3,106,64,42,Positive
GTY,2020-Q2,58,47,11,Positive
BANC,2020-Q3,143,60,83,Positive
GEL,2021-Q1,44,48,-4,Negative
CNR,2020-Q1,113,60,53,Positive
AAT,2021-Q1,61,51,10,Positive
DNOW,2021-Q1,105,49,56,Positive
OIS,2021-Q1,54,49,5,Positive
CABO,2019-Q2,60,28,32,Positive
RH,2019-Q3,71,40,31,Positive
APG,2021-Q1,117,51,66,Positive
EB,2019-Q3,73,21,52,Positive
ACM,2020-Q2,108,59,49,Positive
INVH,2020-Q4,118,36,82,Positive
NFG,2021-Q1,81,41,40,Positive
NPO,2021-Q1,128,52,76,Positive
GTN,2020-Q3,99,48,51,Positive
GDOT,2021-Q1,81,32,49,Positive
AVNS,2020-Q2,101,69,32,Positive
POST,2021-Q1,102,78,24,Positive
BSM,2020-Q3,59,49,10,Positive
LPG,2021-Q2,64,64,0,Neutral
AIR,2019-Q4,99,30,69,Positive
IPI,2021-Q1,35,22,13,Positive
GMS,2020-Q1,101,40,61,Positive
HGV,2021-Q1,153,39,114,Positive
LBRT,2019-Q4,105,67,38,Positive
CPRI,2021-Q4,137,43,94,Positive
OGS,2021-Q1,70,42,28,Positive
INSP,2019-Q2,105,34,71,Positive
BCC,2021-Q1,82,62,20,Positive
AGS,2020-Q2,92,53,39,Positive
CARS,2021-Q1,172,39,133,Positive
AMN,2021-Q1,100,49,51,Positive
GIB,2020-Q1,91,51,40,Positive
FMC,2020-Q3,88,37,51,Positive
PHR,2021-Q2,59,47,12,Positive
GTY,2020-Q3,64,61,3,Positive
NFG,2020-Q4,78,38,40,Positive
EVRG,2020-Q2,96,41,55,Positive
BALL,2019-Q2,109,44,65,Positive
BBU,2021-Q1,118,52,66,Positive
ITT,2020-Q3,140,69,71,Positive
FTV,2019-Q3,103,94,9,Positive
AAT,2020-Q4,66,50,16,Positive
LAZ,2019-Q4,95,38,57,Positive
DIS,2023-Q1,137,47,90,Positive
AME,2020-Q4,135,54,81,Positive
HRI,2020-Q1,71,76,-5,Negative
BNED,2019-Q4,101,41,60,Positive
AGI,2020-Q2,47,33,14,Positive
ITGR,2021-Q1,73,33,40,Positive
PRA,2019-Q2,80,149,-69,Negative
FMC,2020-Q2,69,54,15,Positive
NSA,2020-Q1,70,93,-23,Negative
BSM,2021-Q1,73,36,37,Positive
GNL,2020-Q3,45,38,7,Positive
BOOT,2021-Q2,122,71,51,Positive
PEN,2020-Q3,91,51,40,Positive
ORI,2020-Q4,95,77,18,Positive
PBA,2020-Q4,96,52,44,Positive
PFS,2020-Q4,101,52,49,Positive
CALX,2021-Q1,81,64,17,Positive
NVGS,2021-Q1,54,50,4,Positive
ELP,2020-Q4,93,60,33,Positive
ASPN,2021-Q1,74,58,16,Positive
MKC,2021-Q1,149,21,128,Positive
MEI,2021-Q2,65,51,14,Positive
HPP,2020-Q1,56,55,1,Positive
GCI,2019-Q2,138,40,98,Positive
ACA,2020-Q4,144,58,86,Positive
AMBC,2020-Q2,52,82,-30,Negative
AVNT,2019-Q3,109,58,51,Positive
ASB,2021-Q2,79,53,26,Positive
AZUL,2020-Q4,104,45,59,Positive
DX,2020-Q4,108,56,52,Positive
ITGR,2020-Q4,122,44,78,Positive
ONTF,2021-Q1,84,25,59,Positive
BRX,2020-Q3,96,83,13,Positive
ASB,2020-Q2,56,67,-11,Negative
CTVA,2020-Q1,135,67,68,Positive
BWXT,2019-Q4,81,62,19,Positive
OGE,2019-Q4,72,32,40,Positive
ARES,2021-Q1,129,35,94,Positive
AMH,2019-Q4,148,24,124,Positive
FIX,2020-Q3,82,58,24,Positive
BBU,2020-Q2,85,76,9,Positive
PFGC,2020-Q3,105,65,40,Positive
M,2020-Q1,88,89,-1,Negative
MTG,2020-Q4,83,101,-18,Negative
KMT,2020-Q4,81,99,-18,Negative
IDT,2021-Q3,46,22,24,Positive
RBA,2020-Q3,103,47,56,Positive
CXW,2020-Q3,95,92,3,Positive
AYI,2021-Q2,154,49,105,Positive
AM,2020-Q4,51,45,6,Positive
BBDC,2021-Q1,67,51,16,Positive
AZO,2021-Q3,130,38,92,Positive
J,2020-Q2,78,56,22,Positive
NSP,2020-Q1,75,108,-33,Negative
GATX,2020-Q2,52,67,-15,Negative
FNB,2020-Q4,142,34,108,Positive
AHH,2019-Q4,67,32,35,Positive
FOUR,2021-Q1,73,35,38,Positive
BC,2020-Q4,141,45,96,Positive
ELAN,2021-Q1,101,55,46,Positive
LDOS,2021-Q1,91,47,44,Positive
IBP,2020-Q4,118,41,77,Positive
MGY,2019-Q3,26,28,-2,Negative
LHX,2021-Q1,117,47,70,Positive
ENS,2019-Q4,64,65,-1,Negative
AMBC,2019-Q2,52,64,-12,Negative
AME,2021-Q1,133,33,100,Positive
LPG,2021-Q3,54,46,8,Positive
AHH,2020-Q1,82,72,10,Positive
BNED,2020-Q2,114,49,65,Positive
GIB,2021-Q2,131,24,107,Positive
PRA,2020-Q4,88,107,-19,Negative
FTS,2019-Q3,69,38,31,Positive
ADNT,2020-Q4,116,73,43,Positive
NEXA,2021-Q1,80,62,18,Positive
CIO,2020-Q3,106,47,59,Positive
NI,2019-Q4,67,43,24,Positive
CPS,2021-Q1,130,69,61,Positive
CHMI,2020-Q4,75,81,-6,Negative
NNN,2020-Q2,64,58,6,Positive
DFIN,2020-Q1,89,38,51,Positive
CWEN,2020-Q1,66,62,4,Positive
BILL,2020-Q4,77,52,25,Positive
CPRI,2021-Q3,136,66,70,Positive
EVTC,2020-Q3,63,40,23,Positive
KTB,2020-Q2,174,78,96,Positive
FNB,2020-Q3,121,47,74,Positive
CNMD,2021-Q1,70,63,7,Positive
BFH,2020-Q1,105,107,-2,Negative
CBT,2021-Q1,135,45,90,Positive
EBR,2020-Q3,40,49,-9,Negative
OSCR,2021-Q1,119,33,86,Positive
LZB,2021-Q1,86,80,6,Positive
CMI,2020-Q4,56,72,-16,Negative
ACM,2020-Q3,168,45,123,Positive
CLX,2021-Q1,140,28,112,Positive
INSP,2019-Q3,94,36,58,Positive
CTRE,2020-Q2,60,70,-10,Negative
GGG,2021-Q2,72,53,19,Positive
CHMI,2021-Q1,34,27,7,Positive
BAP,2021-Q1,73,77,-4,Negative
LTC,2020-Q3,50,63,-13,Negative
NOMD,2020-Q3,82,54,28,Positive
MDU,2020-Q4,74,39,35,Positive
ACA,2021-Q1,117,52,65,Positive
ELP,2021-Q1,65,48,17,Positive
NSA,2019-Q3,80,44,36,Positive
OLO,2021-Q1,102,19,83,Positive
BALL,2019-Q4,119,32,87,Positive
CYH,2021-Q1,133,42,91,Positive
MSM,2021-Q3,79,59,20,Positive
BILL,2020-Q3,65,57,8,Positive
EB,2020-Q1,81,53,28,Positive
NBHC,2020-Q3,110,66,44,Positive
EPC,2020-Q2,114,64,50,Positive
OGS,2020-Q4,70,70,0,Neutral
GPK,2019-Q2,95,37,58,Positive
ESNT,2020-Q3,101,84,17,Positive
BWXT,2019-Q3,52,42,10,Positive
NEU,2019-Q3,28,13,15,Positive
REXR,2021-Q1,94,72,22,Positive
LYV,2020-Q3,74,41,33,Positive
LRN,2021-Q3,76,40,36,Positive
DOC,2020-Q3,93,44,49,Positive
INVH,2020-Q3,84,45,39,Positive
EXR,2020-Q3,73,64,9,Positive
CULP,2020-Q2,142,52,90,Positive
LBRT,2021-Q1,141,59,82,Positive
AVTR,2021-Q1,131,31,100,Positive
PEB,2020-Q4,120,60,60,Positive
REZI,2020-Q1,81,58,23,Positive
EIG,2021-Q1,43,71,-28,Negative
NHI,2020-Q3,72,69,3,Positive
EFC,2020-Q3,100,45,55,Positive
GTN,2019-Q4,84,36,48,Positive
ONTO,2019-Q4,87,41,46,Positive
CYH,2020-Q4,110,50,60,Positive
PK,2021-Q1,115,46,69,Positive
CNR,2021-Q1,168,27,141,Positive
NHI,2020-Q4,84,71,13,Positive
LII,2020-Q1,62,75,-13,Negative
FTV,2020-Q1,61,97,-36,Negative
ADCT,2021-Q1,42,46,-4,Negative
CBU,2021-Q2,87,40,47,Positive
PNW,2021-Q1,41,48,-7,Negative
AZO,2019-Q4,124,45,79,Positive
COO,2021-Q2,136,37,99,Positive
AVNS,2019-Q4,116,41,75,Positive
GTN,2020-Q4,74,65,9,Positive
ADM,2021-Q2,147,34,113,Positive
RITM,2022-Q4,96,42,54,Positive
RAMP,2020-Q2,132,32,100,Positive
RES,2021-Q1,31,48,-17,Negative
MGY,2020-Q1,73,62,11,Positive
ARMK,2019-Q4,132,35,97,Positive
NSP,2020-Q2,89,65,24,Positive
FN,2021-Q2,90,59,31,Positive
MCS,2020-Q3,75,69,6,Positive
EB,2019-Q4,122,33,89,Positive
BXP,2021-Q1,43,44,-1,Negative
GPK,2021-Q1,111,34,77,Positive
CTRE,2021-Q1,72,48,24,Positive
IEX,2021-Q1,105,55,50,Positive
HE,2021-Q1,124,47,77,Positive
NVST,2021-Q1,148,48,100,Positive
FBK,2020-Q2,85,69,16,Positive
RIO,2020-Q2,130,75,55,Positive
AMH,2019-Q3,114,31,83,Positive
ADNT,2021-Q2,108,79,29,Positive
OSK,2021-Q1,128,66,62,Positive
HOUS,2020-Q1,91,95,-4,Negative
IBP,2020-Q1,100,90,10,Positive
AIR,2020-Q2,111,38,73,Positive
IRT,2020-Q4,114,33,81,Positive
OR,2020-Q4,76,43,33,Positive
MCS,2020-Q2,70,70,0,Neutral
PAG,2019-Q4,92,49,43,Positive
EXP,2020-Q3,76,45,31,Positive
RPM,2021-Q4,102,89,13,Positive
GLOB,2020-Q3,105,46,59,Positive
MTG,2021-Q1,100,110,-10,Negative
REXR,2020-Q2,88,50,38,Positive
CCO,2020-Q1,75,87,-12,Negative
ACM,2020-Q1,143,41,102,Positive
LPG,2021-Q4,63,48,15,Positive
LRN,2020-Q2,83,39,44,Positive
NFG,2020-Q3,85,51,34,Positive
NEXA,2020-Q3,83,59,24,Positive
GTN,2021-Q1,84,42,42,Positive
EVTC,2020-Q4,103,38,65,Positive
GNL,2020-Q2,80,45,35,Positive
ASB,2021-Q1,92,55,37,Positive
NXRT,2020-Q2,59,72,-13,Negative
PARR,2020-Q3,114,73,41,Positive
CSL,2020-Q3,118,73,45,Positive
GRBK,2020-Q4,106,45,61,Positive
PRI,2020-Q4,75,64,11,Positive
INVH,2021-Q1,126,39,87,Positive
ATGE,2020-Q2,95,39,56,Positive
MTW,2021-Q1,66,63,3,Positive
HWM,2020-Q2,51,69,-18,Negative
CUBE,2020-Q2,62,59,3,Positive
BLD,2021-Q1,114,50,64,Positive
GNL,2020-Q1,65,35,30,Positive
NBHC,2020-Q2,89,57,32,Positive
GL,2021-Q2,62,54,8,Positive
CCS,2020-Q4,122,34,88,Positive
OR,2020-Q2,82,37,45,Positive
AGS,2020-Q1,71,85,-14,Negative
KKR,2020-Q4,105,43,62,Positive
EVTC,2020-Q2,76,49,27,Positive
NSA,2020-Q3,85,52,33,Positive
MUSA,2021-Q1,95,47,48,Positive
BSM,2020-Q4,62,45,17,Positive
EGP,2020-Q3,85,65,20,Positive
FHI,2020-Q3,57,47,10,Positive
DX,2020-Q3,71,29,42,Positive
GDDY,2020-Q4,132,35,97,Positive
ATR,2019-Q3,107,52,55,Positive
INVH,2020-Q2,91,53,38,Positive
FTS,2020-Q1,68,71,-3,Negative
HWM,2020-Q3,81,50,31,Positive
LYV,2021-Q1,118,34,84,Positive
KODK,2021-Q1,43,12,31,Positive
IRT,2021-Q1,94,43,51,Positive
RAMP,2021-Q3,110,30,80,Positive
GTN,2020-Q1,68,66,2,Positive
PARR,2020-Q1,55,77,-22,Negative
CWT,2020-Q3,44,55,-11,Negative
NTST,2021-Q1,83,34,49,Positive
GGG,2019-Q3,62,86,-24,Negative
AWR,2021-Q1,32,31,1,Positive
CCI,2021-Q2,68,33,35,Positive
PRI,2020-Q3,96,62,34,Positive
EXR,2020-Q2,87,89,-2,Negative
PFGC,2021-Q1,115,62,53,Positive
BCC,2020-Q1,60,76,-16,Negative
ITT,2020-Q2,159,77,82,Positive
HOUS,2019-Q2,128,45,83,Positive
BLD,2019-Q4,111,35,76,Positive
BILL,2021-Q3,111,26,85,Positive
BV,2021-Q1,150,42,108,Positive
CEPU,2020-Q3,20,31,-11,Negative
FIX,2020-Q4,133,49,84,Positive
AGS,2019-Q4,104,32,72,Positive
PFGC,2019-Q4,82,55,27,Positive
DOC,2020-Q4,113,31,82,Positive
NEU,2019-Q2,15,16,-1,Negative
BDC,2020-Q1,64,79,-15,Negative
FMX,2020-Q2,79,116,-37,Negative
CNR,2019-Q4,129,47,82,Positive
CVNA,2021-Q1,100,39,61,Positive
NNN,2021-Q1,73,39,34,Positive
OGE,2020-Q1,61,62,-1,Negative
DFIN,2019-Q4,105,39,66,Positive
PB,2021-Q1,53,51,2,Positive
POST,2020-Q4,91,67,24,Positive
MEI,2021-Q4,46,41,5,Positive
ELP,2020-Q2,102,54,48,Positive
EHC,2021-Q1,112,46,66,Positive
CHE,2020-Q2,73,78,-5,Negative
AWR,2020-Q1,31,58,-27,Negative
OLN,2019-Q3,53,82,-29,Negative
NVT,2020-Q1,72,78,-6,Negative
CXW,2020-Q2,84,93,-9,Negative
LYV,2020-Q2,71,55,16,Positive
GIS,2019-Q4,142,52,90,Positive
REZI,2019-Q4,141,51,90,Positive
BBU,2020-Q3,118,56,62,Positive
EFC,2021-Q1,81,60,21,Positive
CWEN,2019-Q4,67,59,8,Positive
J,2020-Q3,107,51,56,Positive
PB,2020-Q4,57,46,11,Positive
HOUS,2021-Q1,164,39,125,Positive
FTS,2020-Q2,47,51,-4,Negative
MD,2020-Q4,78,61,17,Positive
OGE,2020-Q4,75,55,20,Positive
BRBR,2021-Q2,114,40,74,Positive
BBU,2020-Q4,123,49,74,Positive
KTB,2020-Q1,100,94,6,Positive
BE,2020-Q1,72,53,19,Positive
BMA,2020-Q4,50,56,-6,Negative
RBA,2019-Q2,151,24,127,Positive
AMBC,2019-Q4,60,78,-18,Negative
RNR,2020-Q2,131,101,30,Positive
CVNA,2020-Q2,103,41,62,Positive
IDA,2020-Q1,77,72,5,Positive
CAL,2020-Q3,106,65,41,Positive
BNED,2020-Q4,79,57,22,Positive
BHLB,2021-Q2,132,54,78,Positive
KKR,2021-Q1,105,62,43,Positive
EHC,2020-Q4,95,52,43,Positive
IDA,2021-Q1,63,41,22,Positive
BAK,2020-Q4,55,63,-8,Negative
NNN,2020-Q3,59,61,-2,Negative
BMA,2020-Q3,39,33,6,Positive
NBHC,2020-Q4,105,31,74,Positive
HPP,2019-Q4,76,52,24,Positive
CBZ,2020-Q2,103,58,45,Positive
BE,2019-Q3,44,73,-29,Negative
MDU,2019-Q3,37,21,16,Positive
LYV,2019-Q4,84,44,40,Positive
ALC,2020-Q2,117,67,50,Positive
JHX,2020-Q4,114,56,58,Positive
EPRT,2020-Q2,44,48,-4,Negative
HASI,2020-Q3,69,41,28,Positive
HMC,2021-Q4,70,81,-11,Negative
CIO,2020-Q4,87,37,50,Positive
APD,2021-Q1,129,80,49,Positive
NOV,2021-Q1,124,108,16,Positive
NNN,2019-Q4,60,44,16,Positive
NOMD,2020-Q4,100,24,76,Positive
EGP,2020-Q4,82,57,25,Positive
OLN,2020-Q1,41,91,-50,Negative
CNMD,2019-Q3,78,37,41,Positive
PNW,2020-Q4,74,41,33,Positive
CAL,2019-Q4,77,64,13,Positive
PARR,2020-Q2,88,99,-11,Negative
AMN,2020-Q3,97,48,49,Positive
FICO,2021-Q1,57,58,-1,Negative
LTC,2021-Q1,54,55,-1,Negative
BFAM,2020-Q1,67,83,-16,Negative
CEPU,2021-Q1,22,50,-28,Negative
CBU,2020-Q4,94,68,26,Positive
MOH,2021-Q1,80,58,22,Positive
FMX,2020-Q3,117,51,66,Positive
EXP,2020-Q1,100,60,40,Positive
OR,2021-Q1,79,33,46,Positive
CSL,2020-Q4,124,64,60,Positive
NVST,2020-Q1,83,67,16,Positive
GTY,2019-Q3,57,27,30,Positive
PAG,2019-Q3,92,51,41,Positive
FND,2019-Q4,106,25,81,Positive
HASI,2020-Q2,79,71,8,Positive
HUBS,2019-Q2,116,41,75,Positive
AZEK,2021-Q2,98,38,60,Positive
RH,2020-Q4,68,44,24,Positive
PARR,2019-Q3,106,71,35,Positive
EVR,2021-Q1,99,40,59,Positive
OLN,2020-Q4,99,65,34,Positive
BE,2019-Q4,55,58,-3,Negative
NOV,2020-Q4,129,87,42,Positive
COR,2020-Q1,92,51,41,Positive
MCS,2020-Q4,78,46,32,Positive
BHE,2020-Q3,99,44,55,Positive
CWK,2020-Q4,104,43,61,Positive
OUT,2020-Q2,87,72,15,Positive
GNE,2020-Q3,32,21,11,Positive
FTV,2020-Q3,134,55,79,Positive
DEA,2019-Q4,81,26,55,Positive
MTG,2020-Q3,65,112,-47,Negative
MCS,2021-Q1,101,42,59,Positive
CLH,2020-Q4,92,55,37,Positive
FRO,2021-Q1,51,51,0,Neutral
MYE,2021-Q1,100,46,54,Positive
RS,2019-Q4,125,39,86,Positive
RSG,2020-Q1,96,69,27,Positive
KBH,2020-Q4,103,30,73,Positive
CTVA,2019-Q4,119,56,63,Positive
CNS,2019-Q4,119,48,71,Positive
IBP,2019-Q4,116,23,93,Positive
ATGE,2021-Q2,101,50,51,Positive
COR,2020-Q2,91,49,42,Positive
NEXA,2020-Q2,55,92,-37,Negative
INN,2021-Q1,96,51,45,Positive
BHE,2020-Q2,78,65,13,Positive
ORI,2020-Q3,96,97,-1,Negative
HPP,2021-Q1,52,44,8,Positive
MAX,2021-Q1,54,21,33,Positive
GTN,2020-Q2,91,68,23,Positive
BSM,2020-Q2,65,58,7,Positive
DD,2021-Q1,85,42,43,Positive
NI,2020-Q4,72,32,40,Positive
AQN,2019-Q4,105,30,75,Positive
EVRI,2021-Q1,107,30,77,Positive
NGVT,2021-Q1,126,32,94,Positive
CLH,2020-Q2,60,74,-14,Negative
LTC,2020-Q2,67,56,11,Positive
NBHC,2021-Q2,102,40,62,Positive
IIPR,2020-Q4,58,27,31,Positive
FHI,2020-Q4,52,42,10,Positive
CMI,2020-Q3,90,79,11,Positive
NEU,2019-Q4,13,5,8,Positive
IDA,2019-Q4,69,37,32,Positive
AAT,2020-Q3,58,90,-32,Negative
HNI,2020-Q3,107,40,67,Positive
OSK,2020-Q4,120,49,71,Positive
FIX,2021-Q1,108,41,67,Positive
IDA,2020-Q4,82,43,39,Positive
GEF,2021-Q2,112,49,63,Positive
RES,2020-Q4,86,71,15,Positive
ROL,2020-Q4,119,43,76,Positive
FN,2021-Q3,87,43,44,Positive
AVA,2020-Q2,39,42,-3,Negative
FTV,2020-Q4,179,60,119,Positive
IBP,2019-Q3,146,34,112,Positive
HUBS,2021-Q1,121,31,90,Positive
KAR,2020-Q3,92,55,37,Positive
CULP,2019-Q4,113,57,56,Positive
HESM,2021-Q1,47,29,18,Positive
MCS,2020-Q1,60,84,-24,Negative
AGO,2021-Q1,91,64,27,Positive
CCS,2019-Q4,141,45,96,Positive
BANC,2021-Q1,99,49,50,Positive
AGI,2021-Q1,67,40,27,Positive
PRI,2020-Q1,85,109,-24,Negative
LRN,2021-Q1,105,36,69,Positive
MFC,2021-Q1,122,47,75,Positive
JNPR,2021-Q1,139,54,85,Positive
REX,2019-Q1,37,60,-23,Negative
FMC,2020-Q4,106,69,37,Positive
CCO,2020-Q2,99,46,53,Positive
CCI,2019-Q4,75,56,19,Positive
LRN,2021-Q2,123,16,107,Positive
FSM,2021-Q1,69,49,20,Positive
LDOS,2020-Q4,58,56,2,Positive
CCS,2019-Q3,135,32,103,Positive
RAMP,2020-Q3,138,30,108,Positive
HRI,2019-Q4,141,47,94,Positive
CNR,2019-Q2,99,38,61,Positive
ACI,2020-Q4,101,30,71,Positive
CULP,2020-Q1,117,55,62,Positive
ARLO,2020-Q4,78,47,31,Positive
ATR,2019-Q2,91,63,28,Positive
HBM,2020-Q3,78,59,19,Positive
OTIS,2021-Q1,140,34,106,Positive
DOV,2020-Q3,113,62,51,Positive
CCS,2019-Q2,108,46,62,Positive
REZI,2021-Q1,95,36,59,Positive
FCPT,2020-Q2,87,46,41,Positive
GES,2022-Q1,118,62,56,Positive
FTS,2019-Q4,85,49,36,Positive
IIIN,2019-Q3,76,80,-4,Negative
CSTM,2020-Q4,113,59,54,Positive
RNR,2021-Q1,136,106,30,Positive
MYE,2020-Q2,106,61,45,Positive
DBI,2021-Q1,149,59,90,Positive
CVS,2022-Q4,133,33,100,Positive
EVRG,2021-Q1,87,34,53,Positive
RIO,2020-Q4,151,65,86,Positive
BLD,2020-Q3,146,52,94,Positive
GNE,2020-Q2,44,30,14,Positive
KREF,2021-Q1,94,43,51,Positive
ESNT,2020-Q2,57,103,-46,Negative
MYE,2020-Q4,109,31,78,Positive
CHCT,2020-Q4,56,37,19,Positive
FTS,2020-Q3,82,41,41,Positive
APTV,2021-Q1,109,74,35,Positive
RSG,2021-Q1,143,41,102,Positive
PDM,2020-Q4,80,34,46,Positive
CHCT,2020-Q2,60,51,9,Positive
EPRT,2021-Q1,74,59,15,Positive
RLX,2021-Q1,53,57,-4,Negative
DNB,2020-Q4,81,30,51,Positive
OMF,2020-Q4,95,69,26,Positive
NXRT,2021-Q2,52,61,-9,Negative
CSTM,2020-Q3,99,55,44,Positive
BRBR,2020-Q4,109,48,61,Positive
CHE,2020-Q4,57,70,-13,Negative
BNED,2021-Q3,107,53,54,Positive
GATX,2020-Q1,94,102,-8,Negative
EVRI,2020-Q3,116,36,80,Positive
M,2021-Q1,172,30,142,Positive
IBP,2019-Q2,123,41,82,Positive
CEPU,2020-Q4,39,61,-22,Negative
COR,2020-Q4,67,35,32,Positive
NVST,2020-Q2,119,67,52,Positive
IRT,2020-Q2,65,40,25,Positive
NNN,2019-Q3,57,33,24,Positive
HBM,2020-Q2,88,54,34,Positive
AGI,2020-Q4,66,39,27,Positive
ARMK,2019-Q3,115,29,86,Positive
FBK,2020-Q4,109,47,62,Positive
KBH,2021-Q2,107,35,72,Positive
BWXT,2020-Q1,52,73,-21,Negative
REZI,2020-Q4,112,48,64,Positive
FND,2019-Q3,85,34,51,Positive
DG,2019-Q2,141,13,128,Positive
IAG,2020-Q2,77,54,23,Positive
IIIN,2020-Q3,74,71,3,Positive
FTV,2021-Q1,143,23,120,Positive
EXP,2021-Q1,100,56,44,Positive
DG,2020-Q1,118,47,71,Positive
HBM,2020-Q4,76,39,37,Positive
HESM,2020-Q1,65,46,19,Positive
BRX,2021-Q1,122,40,82,Positive
GNE,2021-Q1,39,21,18,Positive
AVTR,2020-Q3,121,45,76,Positive
AZO,2019-Q3,124,36,88,Positive
GGG,2020-Q3,97,73,24,Positive
BLD,2020-Q4,105,54,51,Positive
NHI,2021-Q1,64,53,11,Positive
ETN,2021-Q1,120,54,66,Positive
EGP,2020-Q2,62,63,-1,Negative
ICL,2021-Q1,107,54,53,Positive
DNB,2020-Q3,86,22,64,Positive
DEA,2019-Q3,84,22,62,Positive
MSA,2021-Q1,140,56,84,Positive
GBCI,2021-Q1,76,28,48,Positive
ACM,2021-Q2,159,36,123,Positive
EIG,2019-Q3,49,56,-7,Negative
CALX,2020-Q4,73,64,9,Positive
BRX,2020-Q1,77,79,-2,Negative
AR,2021-Q1,89,52,37,Positive
BC,2021-Q1,135,31,104,Positive
PRA,2019-Q4,79,111,-32,Negative
AM,2021-Q1,48,30,18,Positive
NVST,2019-Q4,111,46,65,Positive
OMF,2020-Q2,87,115,-28,Negative
CWK,2021-Q1,107,48,59,Positive
DOV,2020-Q4,114,48,66,Positive
DG,2019-Q4,148,19,129,Positive
AROC,2021-Q1,83,41,42,Positive
OGS,2020-Q2,54,69,-15,Negative
CX,2021-Q1,106,39,67,Positive
GPK,2019-Q4,101,37,64,Positive
AROC,2020-Q4,122,60,62,Positive
CBZ,2019-Q4,116,36,80,Positive
BRBR,2021-Q1,79,40,39,Positive
GPK,2020-Q2,93,57,36,Positive
ADNT,2021-Q1,111,71,40,Positive
IAG,2020-Q3,60,52,8,Positive
HOUS,2019-Q3,119,53,66,Positive
ORI,2021-Q2,79,40,39,Positive
AMRC,2020-Q3,118,52,66,Positive
PRI,2020-Q2,90,88,2,Positive
GLOB,2019-Q3,115,43,72,Positive
GBX,2021-Q2,110,67,43,Positive
RS,2019-Q2,92,54,38,Positive
DG,2019-Q3,154,13,141,Positive
CCO,2021-Q1,80,59,21,Positive
PJT,2021-Q1,98,68,30,Positive
JNPR,2021-Q2,155,46,109,Positive
BCC,2020-Q4,83,44,39,Positive
NTR,2020-Q2,138,48,90,Positive
IAG,2020-Q4,58,41,17,Positive
FMX,2020-Q4,87,65,22,Positive
EPRT,2020-Q4,79,71,8,Positive
EPC,2020-Q4,186,65,121,Positive
AZUL,2019-Q4,76,65,11,Positive
RDN,2019-Q2,68,61,7,Positive
CLX,2021-Q3,123,49,74,Positive
ARES,2020-Q3,110,59,51,Positive
FMC,2021-Q1,72,42,30,Positive
MYE,2020-Q3,102,25,77,Positive
AMCR,2020-Q3,89,66,23,Positive
RELX,2019-Q4,81,60,21,Positive
ALE,2021-Q1,87,47,40,Positive
DFIN,2019-Q2,60,30,30,Positive
CWT,2020-Q2,48,76,-28,Negative
BRX,2020-Q2,73,95,-22,Negative
DIN,2021-Q1,134,36,98,Positive
IRT,2020-Q3,48,23,25,Positive
KUKE,2020-Q4,87,46,41,Positive
LCII,2021-Q1,155,36,119,Positive
INN,2020-Q4,118,56,62,Positive
PFGC,2021-Q3,119,56,63,Positive
CVNA,2019-Q4,111,26,85,Positive
CPB,2020-Q2,184,67,117,Positive
HESM,2020-Q3,85,23,62,Positive
GIB,2019-Q4,112,32,80,Positive
CPRI,2020-Q3,116,52,64,Positive
ARES,2020-Q2,137,55,82,Positive
RNR,2020-Q4,132,87,45,Positive
PNNT,2021-Q2,86,54,32,Positive
OGS,2020-Q3,39,45,-6,Negative
FHI,2021-Q1,54,58,-4,Negative
RH,2021-Q1,73,41,32,Positive
ARMK,2020-Q1,125,39,86,Positive
CBZ,2021-Q1,110,40,70,Positive
MFC,2020-Q4,158,78,80,Positive
FHI,2020-Q1,56,41,15,Positive
CODI,2020-Q1,85,75,10,Positive
AYI,2021-Q3,153,15,138,Positive
NNN,2020-Q4,71,39,32,Positive
HASI,2021-Q1,93,56,37,Positive
PHR,2022-Q1,96,53,43,Positive
RES,2020-Q3,84,76,8,Positive
BOX,2020-Q1,130,48,82,Positive
GGG,2021-Q1,98,63,35,Positive
AMRC,2020-Q2,98,47,51,Positive
CTRE,2020-Q4,64,37,27,Positive
HOUS,2020-Q4,119,50,69,Positive
BDC,2019-Q3,67,53,14,Positive
BOX,2021-Q2,140,30,110,Positive
PINS,2021-Q1,94,39,55,Positive
GPK,2020-Q4,122,35,87,Positive
PRA,2021-Q1,102,98,4,Positive
AVNT,2020-Q1,70,86,-16,Negative
GWRE,2021-Q3,126,40,86,Positive
LXP,2020-Q4,95,22,73,Positive
ARES,2020-Q4,115,44,71,Positive
EIG,2019-Q4,73,87,-14,Negative
BOX,2020-Q3,136,50,86,Positive
HESM,2020-Q4,75,16,59,Positive
LDOS,2020-Q2,59,69,-10,Negative
IR,2020-Q3,140,33,107,Positive
BOOT,2021-Q4,151,44,107,Positive
ADT,2021-Q1,107,37,70,Positive
M,2020-Q3,148,45,103,Positive
AAT,2020-Q2,67,58,9,Positive
BNED,2020-Q3,86,29,57,Positive
RGS,2021-Q3,75,58,17,Positive
LAZ,2020-Q1,59,100,-41,Negative
PRA,2020-Q2,93,125,-32,Negative
GRBK,2019-Q2,57,29,28,Positive
CMP,2021-Q1,107,40,67,Positive
EVRG,2020-Q3,73,54,19,Positive
LPG,2021-Q1,61,62,-1,Negative
FBK,2021-Q2,108,46,62,Positive
OLN,2019-Q2,66,64,2,Positive
BCC,2019-Q3,74,69,5,Positive
RDN,2019-Q4,59,60,-1,Negative
CUBE,2020-Q3,80,33,47,Positive
RPM,2021-Q3,112,54,58,Positive
CCI,2020-Q1,77,51,26,Positive
CULP,2021-Q4,146,53,93,Positive
CALX,2021-Q2,81,38,43,Positive
GIB,2021-Q1,110,33,77,Positive
CODI,2021-Q1,113,44,69,Positive
HPP,2020-Q2,58,67,-9,Negative
MSA,2020-Q4,142,59,83,Positive
AVNS,2021-Q1,98,45,53,Positive
REXR,2020-Q4,97,48,49,Positive
BOOT,2021-Q1,99,104,-5,Negative
GIS,2020-Q2,150,43,107,Positive
BCC,2019-Q4,76,60,16,Positive
BE,2019-Q2,42,93,-51,Negative
PFGC,2021-Q2,121,67,54,Positive
OLN,2019-Q4,62,86,-24,Negative
GHLD,2021-Q1,121,21,100,Positive
BFAM,2019-Q3,97,26,71,Positive
BFH,2020-Q4,136,47,89,Positive
ALC,2020-Q4,111,49,62,Positive
LYV,2019-Q3,82,35,47,Positive
CODI,2020-Q3,100,58,42,Positive
BHLB,2021-Q1,121,38,83,Positive
GNE,2020-Q1,49,36,13,Positive
GTES,2020-Q3,136,49,87,Positive
KREF,2020-Q1,54,61,-7,Negative
AMBC,2020-Q1,67,133,-66,Negative
AVNT,2019-Q2,103,62,41,Positive
GNE,2019-Q3,29,24,5,Positive
MGY,2019-Q4,73,47,26,Positive
AWR,2020-Q3,35,57,-22,Negative
EFC,2020-Q4,103,46,57,Positive
ACEL,2020-Q1,45,57,-12,Negative
BV,2020-Q4,134,68,66,Positive
PJT,2020-Q2,70,73,-3,Negative
NVST,2020-Q3,142,49,93,Positive
LNN,2021-Q2,73,42,31,Positive
FCPT,2019-Q3,44,33,11,Positive
AAP,2019-Q3,163,43,120,Positive
FTS,2021-Q1,84,37,47,Positive
NEU,2020-Q1,9,18,-9,Negative
RM,2021-Q1,108,56,52,Positive
PRU,2022-Q4,95,36,59,Positive
MGY,2019-Q2,61,50,11,Positive
BV,2020-Q3,105,62,43,Positive
BNED,2021-Q2,60,66,-6,Negative
RM,2020-Q4,109,62,47,Positive
BFH,2020-Q3,144,36,108,Positive
FMX,2021-Q1,104,55,49,Positive
OFG,2020-Q4,57,38,19,Positive
CNNE,2021-Q1,29,22,7,Positive
KMT,2021-Q1,113,71,42,Positive
APLE,2021-Q1,175,30,145,Positive
CNS,2019-Q3,102,55,47,Positive
HOUS,2020-Q3,136,33,103,Positive
AROC,2019-Q3,117,34,83,Positive
NOV,2020-Q3,125,86,39,Positive
PFS,2020-Q3,83,67,16,Positive
HASI,2020-Q1,91,57,34,Positive
GDDY,2021-Q1,130,25,105,Positive
GNL,2021-Q1,51,27,24,Positive
LZB,2021-Q2,93,50,43,Positive
BANC,2021-Q2,122,33,89,Positive
KTB,2021-Q1,123,31,92,Positive
MEI,2021-Q1,76,54,22,Positive
LYV,2020-Q1,61,77,-16,Negative
CODI,2020-Q4,117,54,63,Positive
AZZ,2022-Q1,125,54,71,Positive
ALC,2020-Q3,124,61,63,Positive
GGG,2019-Q4,96,53,43,Positive
BV,2020-Q2,114,71,43,Positive
ROL,2021-Q1,147,31,116,Positive
BMA,2020-Q2,43,84,-41,Negative
AMH,2019-Q2,57,32,25,Positive
FRO,2020-Q4,54,49,5,Positive
ENS,2021-Q2,88,57,31,Positive
DRH,2020-Q1,77,72,5,Positive
IBP,2021-Q1,99,70,29,Positive
KBH,2021-Q1,112,35,77,Positive
AVNT,2020-Q4,106,42,64,Positive
LOB,2021-Q2,103,49,54,Positive
NBHC,2021-Q1,76,28,48,Positive
AGRO,2020-Q1,61,63,-2,Negative
GLOB,2020-Q2,86,38,48,Positive
COR,2020-Q3,105,36,69,Positive
KREF,2020-Q4,111,50,61,Positive
FCPT,2020-Q3,57,32,25,Positive
HPP,2020-Q4,73,50,23,Positive
BFAM,2019-Q4,99,32,67,Positive
GHG,2021-Q1,61,53,8,Positive
J,2021-Q2,99,35,64,Positive
MTDR,2020-Q4,98,32,66,Positive
DEA,2020-Q4,125,38,87,Positive
ATO,2021-Q2,86,32,54,Positive
PAG,2020-Q1,56,64,-8,Negative
AMBC,2021-Q1,70,37,33,Positive
ITT,2020-Q4,129,50,79,Positive
CTRE,2020-Q3,93,55,38,Positive
CCO,2020-Q4,105,42,63,Positive
OUT,2020-Q3,83,48,35,Positive
RBA,2020-Q1,86,91,-5,Negative
MTRN,2021-Q1,136,25,111,Positive
AX,2019-Q4,93,43,50,Positive
NTR,2020-Q3,87,56,31,Positive
GTES,2020-Q2,127,75,52,Positive
ACA,2020-Q3,140,59,81,Positive
BOX,2022-Q1,134,47,87,Positive
REZI,2019-Q3,82,79,3,Positive
HRI,2019-Q3,125,43,82,Positive
NGVT,2020-Q2,70,63,7,Positive
NSP,2021-Q1,109,52,57,Positive
PAG,2019-Q2,92,41,51,Positive
GL,2020-Q4,45,59,-14,Negative
GTY,2021-Q1,39,24,15,Positive
EVR,2020-Q4,109,43,66,Positive
CLH,2020-Q3,81,59,22,Positive
LAZ,2021-Q1,111,52,59,Positive
ITT,2021-Q1,133,45,88,Positive
OSK,2020-Q3,107,76,31,Positive
MC,2021-Q1,70,64,6,Positive
BNED,2021-Q1,81,57,24,Positive
ACM,2021-Q1,165,38,127,Positive
HWM,2021-Q1,62,41,21,Positive
RDN,2020-Q1,65,137,-72,Negative
INSP,2019-Q4,106,28,78,Positive
CHMI,2020-Q2,64,62,2,Positive
CCO,2020-Q3,114,51,63,Positive
CEPU,2020-Q2,31,59,-28,Negative
LII,2019-Q3,72,69,3,Positive
FTV,2019-Q4,121,70,51,Positive
DNB,2021-Q1,106,21,85,Positive
ATGE,2021-Q3,110,63,47,Positive
IHG,2020-Q1,72,82,-10,Negative
MEG,2021-Q1,93,44,49,Positive
CMI,2020-Q2,76,100,-24,Negative
AVA,2020-Q4,73,35,38,Positive
EBR,2021-Q1,46,62,-16,Negative
CAL,2020-Q1,81,95,-14,Negative
DIN,2020-Q4,128,60,68,Positive
KN,2021-Q1,68,38,30,Positive
CTVA,2020-Q3,146,40,106,Positive
EB,2019-Q2,31,25,6,Positive
BHE,2020-Q1,70,80,-10,Negative
GATX,2020-Q3,76,59,17,Positive
ACM,2019-Q4,115,56,59,Positive
CBZ,2020-Q4,109,72,37,Positive
ALC,2021-Q1,139,58,81,Positive
GNE,2019-Q2,20,30,-10,Negative
FND,2019-Q2,107,21,86,Positive
MC,2020-Q4,109,51,58,Positive
AVNS,2020-Q4,108,71,37,Positive
GBCI,2021-Q2,87,40,47,Positive
ROL,2020-Q1,50,61,-11,Negative
PBA,2021-Q1,83,29,54,Positive
AME,2020-Q2,137,69,68,Positive
GDDY,2020-Q1,93,45,48,Positive
AYI,2020-Q4,122,62,60,Positive
CAL,2020-Q4,117,76,41,Positive
ELP,2020-Q3,89,56,33,Positive
AROC,2020-Q1,82,79,3,Positive
AAP,2019-Q1,153,51,102,Positive
OLN,2021-Q1,94,46,48,Positive
APG,2020-Q4,100,52,48,Positive
FCPT,2019-Q2,54,36,18,Positive
ARCO,2020-Q4,139,51,88,Positive
NI,2019-Q3,50,60,-10,Negative
HI,2021-Q1,138,44,94,Positive
DNOW,2020-Q4,94,66,28,Positive
EXR,2020-Q4,84,71,13,Positive
IRT,2020-Q1,64,57,7,Positive
ATGE,2020-Q3,86,81,5,Positive
BDC,2019-Q2,66,81,-15,Negative
EPC,2021-Q2,128,71,57,Positive
ETN,2019-Q4,95,64,31,Positive
ELF,2021-Q4,109,48,61,Positive
EPC,2021-Q1,143,68,75,Positive
AMN,2020-Q4,78,67,11,Positive
FICO,2021-Q2,80,54,26,Positive
PUMP,2020-Q4,136,51,85,Positive
LII,2021-Q2,84,34,50,Positive
M,2020-Q4,171,49,122,Positive
ESI,2020-Q4,115,80,35,Positive
HWM,2020-Q4,83,44,39,Positive
CTVA,2020-Q2,94,63,31,Positive
DFIN,2019-Q3,67,56,11,Positive
EXP,2021-Q3,80,47,33,Positive
PNNT,2021-Q1,86,89,-3,Negative
RBA,2021-Q1,88,42,46,Positive
BHLB,2020-Q4,75,39,36,Positive
PEN,2019-Q3,103,65,38,Positive
REXR,2020-Q3,100,72,28,Positive
EHC,2020-Q3,81,81,0,Neutral
MATV,2021-Q1,117,37,80,Positive
MPW,2020-Q4,81,33,48,Positive
PDM,2021-Q1,104,27,77,Positive
FTV,2020-Q2,148,67,81,Positive
DEI,2021-Q1,71,52,19,Positive
DNOW,2020-Q3,91,60,31,Positive
OR,2020-Q3,108,31,77,Positive
J,2020-Q1,125,44,81,Positive
NXRT,2021-Q1,77,45,32,Positive
CHCT,2020-Q3,72,56,16,Positive
KREF,2019-Q4,94,41,53,Positive
LYV,2019-Q2,96,20,76,Positive
AME,2020-Q3,125,60,65,Positive
CAL,2019-Q1,85,45,40,Positive
PJT,2020-Q4,100,65,35,Positive
KAR,2020-Q4,95,76,19,Positive
HPP,2020-Q3,88,52,36,Positive
PD,2022-Q1,78,66,12,Positive
EIG,2019-Q2,78,79,-1,Negative
AGI,2020-Q3,75,63,12,Positive
KREF,2021-Q2,82,63,19,Positive
MFC,2020-Q3,111,79,32,Positive
RNR,2020-Q3,97,138,-41,Negative
PRA,2020-Q1,44,154,-110,Negative
EPC,2020-Q3,138,73,65,Positive
LAZ,2019-Q3,74,57,17,Positive
MD,2021-Q1,79,56,23,Positive
ETN,2020-Q4,106,57,49,Positive
IAG,2021-Q1,78,26,52,Positive
NX,2021-Q2,99,62,37,Positive
PB,2020-Q3,63,41,22,Positive
BRX,2019-Q4,106,67,39,Positive
RELX,2020-Q4,93,70,23,Positive
REZI,2019-Q2,69,28,41,Positive
CBU,2021-Q1,81,68,13,Positive
JNPR,2020-Q4,131,52,79,Positive
LRN,2020-Q3,82,52,30,Positive
IIIN,2020-Q4,93,82,11,Positive
AWR,2020-Q2,59,39,20,Positive
RC,2021-Q1,74,60,14,Positive
OFG,2021-Q1,94,50,44,Positive
REXR,2021-Q2,87,45,42,Positive
J,2020-Q4,90,47,43,Positive
AGRO,2020-Q3,62,28,34,Positive
GLOB,2020-Q4,118,34,84,Positive
GEL,2020-Q4,54,38,16,Positive
EXP,2021-Q2,69,55,14,Positive
OGE,2021-Q1,101,43,58,Positive
BOOT,2021-Q3,146,48,98,Positive
ESNT,2020-Q4,100,64,36,Positive
NOMD,2020-Q2,119,40,79,Positive
CCS,2021-Q1,104,56,48,Positive
BNED,2020-Q3,86,31,55,Positive
LDOS,2020-Q3,94,63,31,Positive
NI,2021-Q1,61,31,30,Positive
PRA,2019-Q3,100,154,-54,Negative
ESNT,2021-Q1,110,83,27,Positive
CLH,2021-Q1,106,47,59,Positive
CUBE,2020-Q4,99,58,41,Positive
RS,2020-Q1,88,100,-12,Negative
AMBC,2020-Q3,69,101,-32,Negative
NHI,2020-Q2,73,58,15,Positive
APTV,2020-Q4,116,50,66,Positive
AVTR,2020-Q4,112,46,66,Positive
PNW,2020-Q3,81,56,25,Positive
ARLO,2021-Q1,78,37,41,Positive
CSTM,2021-Q1,103,84,19,Positive
CBZ,2019-Q2,75,34,41,Positive
GPK,2020-Q3,95,37,58,Positive
LYV,2020-Q4,57,25,32,Positive
EVRG,2020-Q4,143,32,111,Positive
PB,2020-Q2,64,63,1,Positive
HPP,2019-Q3,96,20,76,Positive
GWRE,2021-Q2,116,37,79,Positive
FBK,2021-Q1,108,52,56,Positive
MED,2021-Q1,85,40,45,Positive
FNB,2020-Q2,78,60,18,Positive
EPC,2019-Q4,129,61,68,Positive
PNW,2020-Q2,61,47,14,Positive
RAMP,2020-Q4,115,67,48,Positive
GIB,2020-Q2,87,76,11,Positive
PRA,2020-Q3,91,115,-24,Negative
CIO,2021-Q1,71,30,41,Positive
AMH,2020-Q4,115,67,48,Positive
CVEO,2021-Q1,51,52,-1,Negative
EVTC,2019-Q2,79,37,42,Positive
CNMD,2019-Q4,93,58,35,Positive
CIG,2020-Q4,87,41,46,Positive
PJT,2020-Q3,87,64,23,Positive
PFS,2020-Q2,48,61,-13,Negative
DX,2021-Q1,86,47,39,Positive
BALL,2020-Q1,87,65,22,Positive
NSP,2020-Q3,103,65,38,Positive
CNA,2021-Q1,91,103,-12,Negative
EGP,2021-Q1,107,58,49,Positive
GNE,2020-Q4,25,37,-12,Negative
NXRT,2020-Q3,68,61,7,Positive
EXR,2021-Q1,83,48,35,Positive
LBRT,2019-Q3,114,54,60,Positive
KAR,2021-Q1,122,35,87,Positive
OMF,2021-Q2,116,63,53,Positive
COMP,2021-Q4,141,26,115,Positive
GIB,2021-Q4,100,28,72,Positive
APTV,2021-Q3,122,61,61,Positive
NVGS,2021-Q2,80,51,29,Positive
ICL,2022-Q1,83,73,10,Positive
APO,2021-Q3,110,38,72,Positive
DV,2021-Q3,100,47,53,Positive
AZEK,2021-Q4,164,27,137,Positive
CCO,2021-Q2,92,47,45,Positive
AME,2021-Q2,121,36,85,Positive
MKC,2022-Q2,88,102,-14,Negative
NET,2021-Q3,124,41,83,Positive
AZZ,2022-Q4,109,40,69,Positive
DBI,2022-Q1,128,26,102,Positive
CARS,2022-Q1,95,35,60,Positive
CBT,2021-Q4,111,37,74,Positive
BV,2021-Q3,137,45,92,Positive
DAC,2021-Q3,51,51,0,Neutral
FTI,2022-Q2,114,24,90,Positive
MUSA,2021-Q4,83,37,46,Positive
CLB,2022-Q4,88,58,30,Positive
LPG,2022-Q2,93,52,41,Positive
MA,2022-Q2,93,33,60,Positive
GDOT,2021-Q2,91,46,45,Positive
CCS,2021-Q3,102,57,45,Positive
HCA,2022-Q1,70,54,16,Positive
NOTE,2022-Q3,92,37,55,Positive
BEP,2021-Q4,126,26,100,Positive
KODK,2022-Q2,55,26,29,Positive
PAY,2022-Q3,35,14,21,Positive
MTRN,2022-Q1,111,34,77,Positive
ETN,2021-Q2,105,36,69,Positive
ESTC,2023-Q2,119,52,67,Positive
CFG,2022-Q2,134,56,78,Positive
AIR,2022-Q1,61,20,41,Positive
AROC,2021-Q3,61,34,27,Positive
ABEV,2022-Q2,108,42,66,Positive
HOUS,2021-Q3,138,40,98,Positive
NOW,2022-Q4,102,28,74,Positive
EVRG,2021-Q3,114,40,74,Positive
O,2022-Q2,77,38,39,Positive
PBF,2022-Q2,71,66,5,Positive
REVG,2022-Q2,59,80,-21,Negative
ATGE,2021-Q4,125,35,90,Positive
MTN,2022-Q1,112,38,74,Positive
REZI,2021-Q3,99,57,42,Positive
BCC,2022-Q2,81,67,14,Positive
CNA,2021-Q4,103,99,4,Positive
PMT,2021-Q4,40,41,-1,Negative
EXP,2022-Q2,77,62,15,Positive
AR,2021-Q3,83,36,47,Positive
AVA,2021-Q2,46,59,-13,Negative
BEP,2022-Q4,113,29,84,Positive
ARES,2021-Q2,113,31,82,Positive
RBA,2022-Q1,81,25,56,Positive
REX,2021-Q2,59,51,8,Positive
LDOS,2021-Q2,72,49,23,Positive
DD,2021-Q2,127,56,71,Positive
PINS,2022-Q2,126,48,78,Positive
BRC,2022-Q1,108,63,45,Positive
KEY,2021-Q3,88,29,59,Positive
PACK,2021-Q3,95,33,62,Positive
AGO,2022-Q1,84,89,-5,Negative
LDI,2021-Q2,98,48,50,Positive
DT,2022-Q2,119,33,86,Positive
EBS,2021-Q2,87,57,30,Positive
ALC,2021-Q2,134,40,94,Positive
GEF,2022-Q3,90,79,11,Positive
FCPT,2021-Q3,76,43,33,Positive
AMN,2021-Q3,100,57,43,Positive
LOW,2021-Q4,140,22,118,Positive
PFE,2021-Q3,83,37,46,Positive
NIO,2021-Q4,47,52,-5,Negative
ARCO,2021-Q2,157,32,125,Positive
LYV,2021-Q3,92,37,55,Positive
DOC,2021-Q2,106,42,64,Positive
PRLB,2022-Q3,86,63,23,Positive
MUSA,2022-Q2,111,42,69,Positive
FOUR,2021-Q3,89,42,47,Positive
RGS,2021-Q4,87,65,22,Positive
FSLY,2021-Q2,59,95,-36,Negative
DFIN,2021-Q2,106,31,75,Positive
LEVI,2021-Q3,124,45,79,Positive
COTY,2022-Q4,91,45,46,Positive
AMWL,2022-Q3,117,42,75,Positive
BLD,2021-Q2,110,33,77,Positive
GHG,2021-Q4,56,90,-34,Negative
LDI,2022-Q3,66,49,17,Positive
CLB,2022-Q3,102,48,54,Positive
FUBO,2021-Q3,122,43,79,Positive
NOW,2021-Q4,122,39,83,Positive
ADNT,2021-Q4,87,95,-8,Negative
MTX,2022-Q1,130,38,92,Positive
PFS,2021-Q3,105,54,51,Positive
M,2021-Q3,147,36,111,Positive
CXM,2022-Q2,93,31,62,Positive
FMC,2021-Q2,70,53,17,Positive
MWA,2021-Q4,89,91,-2,Negative
GEF,2021-Q3,110,55,55,Positive
KBH,2021-Q3,84,57,27,Positive
FBK,2021-Q3,96,44,52,Positive
NPO,2021-Q2,109,41,68,Positive
MCO,2021-Q2,104,41,63,Positive
FIGS,2022-Q3,122,40,82,Positive
BWXT,2022-Q1,90,56,34,Positive
ELF,2023-Q1,150,38,112,Positive
CHWY,2022-Q3,105,26,79,Positive
PINS,2022-Q4,115,40,75,Positive
ALE,2022-Q2,54,34,20,Positive
NIO,2022-Q1,46,59,-13,Negative
OLN,2021-Q3,74,59,15,Positive
BEP,2022-Q2,87,57,30,Positive
ATO,2022-Q1,62,33,29,Positive
NSA,2021-Q2,91,59,32,Positive
FICO,2021-Q3,78,51,27,Positive
ITGR,2021-Q2,87,33,54,Positive
MMM,2022-Q2,163,75,88,Positive
DIS,2022-Q4,126,48,78,Positive
FN,2022-Q1,103,38,65,Positive
BABA,2023-Q1,113,78,35,Positive
BILL,2021-Q3,105,43,62,Positive
EVRI,2021-Q3,104,30,74,Positive
BAP,2022-Q1,115,66,49,Positive
PD,2022-Q2,87,53,34,Positive
RH,2021-Q4,75,48,27,Positive
DVA,2021-Q2,85,50,35,Positive
LNC,2021-Q3,128,71,57,Positive
AX,2022-Q3,119,40,79,Positive
BCC,2021-Q2,90,58,32,Positive
PMT,2021-Q3,36,49,-13,Negative
LBRT,2022-Q1,111,73,38,Positive
NOMD,2021-Q2,94,51,43,Positive
KODK,2021-Q3,43,19,24,Positive
CIG,2022-Q2,58,35,23,Positive
KN,2021-Q3,84,35,49,Positive
RH,2021-Q3,77,50,27,Positive
PNNT,2022-Q1,75,49,26,Positive
CVEO,2022-Q2,57,41,16,Positive
NVT,2021-Q4,121,31,90,Positive
DV,2021-Q2,106,63,43,Positive
EE,2022-Q2,72,49,23,Positive
BFLY,2021-Q3,128,65,63,Positive
CARS,2021-Q3,146,34,112,Positive
FTI,2021-Q3,105,43,62,Positive
RM,2021-Q2,94,54,40,Positive
CWEN,2021-Q2,79,41,38,Positive
ACM,2021-Q3,150,41,109,Positive
ACM,2022-Q2,153,54,99,Positive
CLF,2021-Q4,78,53,25,Positive
MFC,2021-Q3,135,66,69,Positive
HAYW,2022-Q1,125,44,81,Positive
AMRC,2021-Q2,100,47,53,Positive
BFH,2021-Q2,136,44,92,Positive
DIS,2021-Q3,121,55,66,Positive
ALE,2021-Q3,94,37,57,Positive
DTM,2021-Q3,89,15,74,Positive
NVT,2022-Q4,124,39,85,Positive
GRBK,2021-Q2,108,53,55,Positive
CODI,2021-Q2,108,52,56,Positive
BV,2022-Q2,163,26,137,Positive
CNNE,2022-Q1,44,46,-2,Negative
ICL,2022-Q2,119,36,83,Positive
CBU,2021-Q3,109,38,71,Positive
CNS,2021-Q3,101,62,39,Positive
NFG,2021-Q4,95,31,64,Positive
ESNT,2021-Q2,89,61,28,Positive
CCI,2022-Q1,93,35,58,Positive
OGS,2021-Q3,61,31,30,Positive
RDY,2022-Q1,67,81,-14,Negative
GM,2022-Q1,102,32,70,Positive
HRB,2022-Q2,99,46,53,Positive
APAM,2021-Q4,96,48,48,Positive
LDI,2021-Q3,107,64,43,Positive
CNNE,2021-Q2,51,34,17,Positive
MTW,2021-Q3,63,53,10,Positive
ELP,2021-Q2,61,30,31,Positive
EAF,2022-Q3,58,78,-20,Negative
MED,2021-Q3,66,21,45,Positive
KOS,2022-Q2,76,50,26,Positive
RLX,2022-Q2,74,52,22,Positive
NGVT,2022-Q1,128,53,75,Positive
DXC,2022-Q3,134,68,66,Positive
NEU,2021-Q3,9,4,5,Positive
AGO,2022-Q2,68,49,19,Positive
CLF,2022-Q1,79,80,-1,Negative
OHI,2022-Q2,33,72,-39,Negative
CLF,2022-Q2,65,62,3,Positive
GLW,2021-Q3,130,37,93,Positive
KUKE,2021-Q4,53,34,19,Positive
LSPD,2022-Q2,98,36,62,Positive
LMND,2022-Q2,77,85,-8,Negative
MMC,2022-Q3,121,69,52,Positive
CC,2022-Q1,83,47,36,Positive
APO,2022-Q1,105,35,70,Positive
NVT,2022-Q2,142,42,100,Positive
PDM,2021-Q2,80,36,44,Positive
CCI,2022-Q3,66,44,22,Positive
CHCT,2021-Q2,41,18,23,Positive
AVNT,2021-Q3,107,65,42,Positive
CEPU,2021-Q2,15,23,-8,Negative
GHLD,2021-Q2,45,26,19,Positive
EPRT,2021-Q3,82,45,37,Positive
DXC,2022-Q2,137,53,84,Positive
NTST,2021-Q3,68,42,26,Positive
OSK,2021-Q3,112,74,38,Positive
GHG,2021-Q1,69,50,19,Positive
IIIN,2022-Q2,50,55,-5,Negative
PCOR,2022-Q1,147,63,84,Positive
EPAM,2021-Q3,91,28,63,Positive
LAW,2022-Q3,83,56,27,Positive
DV,2022-Q2,118,32,86,Positive
EQNR,2021-Q2,91,86,5,Positive
IPI,2021-Q3,54,32,22,Positive
DEA,2021-Q3,76,38,38,Positive
NVT,2022-Q1,132,31,101,Positive
PAR,2021-Q3,83,54,29,Positive
DEI,2021-Q2,76,75,1,Positive
ESNT,2021-Q3,83,62,21,Positive
GHG,2021-Q2,61,47,14,Positive
DKL,2022-Q2,14,13,1,Positive
MKL,2022-Q1,95,101,-6,Negative
LDI,2021-Q4,114,47,67,Positive
AVA,2021-Q3,44,22,22,Positive
CUBI,2021-Q2,92,37,55,Positive
BUD,2022-Q2,118,54,64,Positive
DEI,2021-Q3,74,37,37,Positive
ELV,2021-Q4,107,42,65,Positive
ANET,2021-Q4,77,42,35,Positive
LOB,2021-Q3,126,28,98,Positive
NI,2021-Q3,72,34,38,Positive
EVRG,2021-Q2,70,32,38,Positive
DVA,2022-Q2,63,58,5,Positive
IEX,2021-Q3,101,92,9,Positive
MTW,2021-Q2,97,64,33,Positive
NVT,2021-Q2,142,25,117,Positive
PLTR,2022-Q3,49,69,-20,Negative
AMH,2021-Q3,122,61,61,Positive
MUR,2022-Q2,117,41,76,Positive
BBDC,2021-Q4,49,61,-12,Negative
PRU,2022-Q1,115,37,78,Positive
GMED,2022-Q1,80,60,20,Positive
KSS,2021-Q4,109,47,62,Positive
PAR,2022-Q1,114,55,59,Positive
BILL,2021-Q4,117,34,83,Positive
NOW,2022-Q3,128,42,86,Positive
CNA,2021-Q3,112,89,23,Positive
PSTG,2023-Q1,130,58,72,Positive
ONTF,2022-Q2,103,68,35,Positive
MAC,2021-Q4,90,36,54,Positive
FTI,2022-Q3,100,40,60,Positive
ROL,2022-Q1,84,47,37,Positive
EAF,2021-Q2,94,42,52,Positive
NVGS,2021-Q4,49,57,-8,Negative
NVST,2021-Q3,115,41,74,Positive
ATO,2021-Q3,49,35,14,Positive
COMP,2022-Q2,122,70,52,Positive
CARS,2021-Q4,120,41,79,Positive
APLE,2021-Q3,150,35,115,Positive
LAZ,2021-Q2,94,48,46,Positive
OKE,2022-Q3,48,48,0,Neutral
LNC,2021-Q2,154,54,100,Positive
CPNG,2022-Q3,136,51,85,Positive
HWM,2021-Q2,69,48,21,Positive
OTIS,2021-Q3,102,57,45,Positive
DEI,2022-Q1,98,53,45,Positive
CVS,2022-Q2,125,35,90,Positive
PAG,2021-Q3,76,32,44,Positive
DD,2021-Q4,106,39,67,Positive
AVNS,2021-Q2,97,52,45,Positive
RMD,2022-Q1,99,53,46,Positive
BV,2022-Q1,135,27,108,Positive
LLY,2022-Q2,83,45,38,Positive
DASH,2022-Q3,98,51,47,Positive
AI,2022-Q1,83,33,50,Positive
DD,2022-Q2,100,57,43,Positive
KKR,2021-Q2,85,53,32,Positive
GDDY,2021-Q2,123,40,83,Positive
LYV,2021-Q2,82,42,40,Positive
RBLX,2022-Q2,90,27,63,Positive
AMWL,2022-Q2,91,50,41,Positive
NX,2022-Q2,86,47,39,Positive
OTIS,2022-Q2,108,50,58,Positive
IEX,2021-Q2,92,63,29,Positive
GHLD,2021-Q4,45,23,22,Positive
RELX,2021-Q2,139,64,75,Positive
IAG,2021-Q2,47,48,-1,Negative
OSCR,2021-Q3,91,33,58,Positive
CMI,2021-Q2,122,37,85,Positive
DIN,2021-Q2,142,34,108,Positive
CNNE,2022-Q2,39,23,16,Positive
PMT,2022-Q2,38,27,11,Positive
POST,2021-Q3,104,89,15,Positive
BABA,2022-Q1,93,40,53,Positive
MTN,2022-Q4,100,36,64,Positive
IDT,2022-Q3,55,32,23,Positive
ALC,2021-Q3,97,45,52,Positive
MCW,2021-Q4,99,52,47,Positive
ELAN,2022-Q2,113,77,36,Positive
PCOR,2022-Q2,102,56,46,Positive
OSCR,2022-Q2,111,46,65,Positive
GFL,2022-Q2,58,49,9,Positive
AZZ,2022-Q2,131,62,69,Positive
PAYC,2022-Q1,122,37,85,Positive
HAL,2022-Q1,99,32,67,Positive
MITT,2021-Q4,63,29,34,Positive
LII,2021-Q3,88,51,37,Positive
FHI,2021-Q2,45,38,7,Positive
OFG,2021-Q4,81,51,30,Positive
EPAM,2021-Q4,59,40,19,Positive
PMT,2021-Q2,50,49,1,Positive
NIO,2021-Q3,46,76,-30,Negative
PBA,2021-Q2,88,47,41,Positive
NGVT,2021-Q2,128,53,75,Positive
EIG,2021-Q3,58,63,-5,Negative
OIS,2021-Q3,75,68,7,Positive
ELV,2021-Q3,146,65,81,Positive
ACM,2022-Q3,168,45,123,Positive
LAW,2021-Q3,94,57,37,Positive
PINS,2021-Q4,101,51,50,Positive
FMC,2021-Q3,88,44,44,Positive
EPAM,2022-Q1,76,47,29,Positive
CNC,2022-Q4,135,58,77,Positive
GM,2021-Q3,99,49,50,Positive
CLB,2021-Q4,89,57,32,Positive
ADM,2021-Q4,139,35,104,Positive
GPK,2022-Q1,92,26,66,Positive
AOMR,2021-Q4,66,28,38,Positive
PRG,2021-Q3,104,46,58,Positive
CCO,2021-Q3,104,32,72,Positive
GLW,2021-Q4,157,27,130,Positive
HGV,2022-Q2,101,41,60,Positive
MMM,2021-Q3,103,84,19,Positive
DKL,2022-Q1,14,10,4,Positive
ABEV,2021-Q3,110,43,67,Positive
RC,2021-Q3,79,62,17,Positive
COP,2022-Q2,72,46,26,Positive
PLNT,2021-Q4,84,61,23,Positive
MA,2021-Q2,106,32,74,Positive
CUBE,2021-Q3,84,56,28,Positive
HGV,2022-Q1,115,39,76,Positive
IR,2022-Q2,115,28,87,Positive
DV,2021-Q4,74,48,26,Positive
BHLB,2021-Q3,119,58,61,Positive
PATH,2022-Q4,78,52,26,Positive
ATO,2022-Q3,52,17,35,Positive
LPG,2022-Q1,58,53,5,Positive
PRI,2021-Q2,71,73,-2,Negative
GHM,2022-Q2,89,46,43,Positive
RKT,2022-Q3,127,53,74,Positive
BDX,2021-Q4,140,27,113,Positive
MKL,2021-Q3,101,73,28,Positive
JMIA,2021-Q4,101,23,78,Positive
ELV,2022-Q1,122,44,78,Positive
AI,2022-Q4,84,43,41,Positive
FHI,2021-Q3,56,36,20,Positive
LOB,2022-Q2,107,38,69,Positive
MKC,2022-Q4,133,81,52,Positive
OTIS,2022-Q4,109,49,60,Positive
RBA,2021-Q3,88,48,40,Positive
CALX,2021-Q3,94,52,42,Positive
MMC,2022-Q4,111,80,31,Positive
BOX,2022-Q3,145,34,111,Positive
BBY,2023-Q3,102,48,54,Positive
PLTR,2021-Q4,51,70,-19,Negative
FIGS,2022-Q1,117,58,59,Positive
GHM,2022-Q1,114,41,73,Positive
BAK,2021-Q3,68,40,28,Positive
HMC,2022-Q3,45,75,-30,Negative
AME,2021-Q3,129,56,73,Positive
LLY,2022-Q3,94,50,44,Positive
ALE,2021-Q4,104,34,70,Positive
ASPN,2021-Q4,82,58,24,Positive
ESTC,2022-Q4,119,38,81,Positive
LLY,2021-Q3,120,52,68,Positive
AOS,2021-Q2,78,46,32,Positive
BCC,2022-Q1,93,41,52,Positive
AGO,2021-Q2,78,57,21,Positive
CWK,2021-Q4,140,20,120,Positive
BAP,2022-Q2,106,68,38,Positive
CC,2021-Q2,124,35,89,Positive
MEI,2022-Q2,60,75,-15,Negative
APLE,2022-Q2,138,35,103,Positive
LCII,2021-Q2,107,48,59,Positive
JHX,2022-Q2,128,20,108,Positive
ROL,2021-Q2,75,37,38,Positive
RBA,2021-Q2,80,45,35,Positive
RSKD,2022-Q1,122,54,68,Positive
CHE,2021-Q3,54,66,-12,Negative
AI,2023-Q2,77,52,25,Positive
ESTC,2022-Q3,123,45,78,Positive
RKT,2021-Q2,111,33,78,Positive
GIB,2021-Q3,87,31,56,Positive
GDDY,2022-Q2,130,28,102,Positive
GIS,2022-Q1,73,56,17,Positive
KR,2021-Q4,140,32,108,Positive
EAT,2021-Q4,125,42,83,Positive
APO,2021-Q2,113,36,77,Positive
DBI,2021-Q3,140,19,121,Positive
GKOS,2021-Q2,64,45,19,Positive
EXR,2021-Q3,97,56,41,Positive
RITM,2022-Q1,90,43,47,Positive
BV,2021-Q4,119,43,76,Positive
GNW,2022-Q3,90,68,22,Positive
BFAM,2022-Q1,106,30,76,Positive
ABBV,2022-Q3,89,43,46,Positive
RF,2022-Q2,100,64,36,Positive
CIO,2021-Q3,76,37,39,Positive
MPW,2022-Q3,79,60,19,Positive
NVGS,2022-Q2,71,40,31,Positive
OHI,2021-Q3,50,82,-32,Negative
RHP,2022-Q1,109,36,73,Positive
MCK,2022-Q1,100,41,59,Positive
NSP,2021-Q2,88,44,44,Positive
MODG,2022-Q1,131,32,99,Positive
NPO,2022-Q1,121,48,73,Positive
CSAN,2021-Q3,104,35,69,Positive
AR,2021-Q2,80,30,50,Positive
APLE,2022-Q1,135,45,90,Positive
EBS,2022-Q2,68,62,6,Positive
MKL,2022-Q2,97,119,-22,Negative
ELAN,2021-Q4,129,42,87,Positive
ONTF,2021-Q3,71,34,37,Positive
ELF,2022-Q4,153,34,119,Positive
MCW,2021-Q3,83,31,52,Positive
BBY,2021-Q4,82,33,49,Positive
PK,2021-Q3,130,49,81,Positive
BOOT,2022-Q2,139,41,98,Positive
KMPR,2021-Q4,82,108,-26,Negative
PSTG,2023-Q2,103,40,63,Positive
OGS,2021-Q2,84,38,46,Positive
GNL,2021-Q2,68,26,42,Positive
LMND,2021-Q3,79,86,-7,Negative
MUR,2021-Q3,98,43,55,Positive
GHLD,2022-Q2,70,40,30,Positive
MPW,2022-Q2,71,53,18,Positive
IHG,2021-Q2,149,30,119,Positive
OSCR,2021-Q4,135,40,95,Positive
BFAM,2022-Q2,59,52,7,Positive
ABBV,2021-Q3,122,40,82,Positive
LRN,2021-Q2,79,37,42,Positive
FTS,2021-Q2,80,45,35,Positive
AOMR,2022-Q1,44,37,7,Positive
GMED,2021-Q4,72,52,20,Positive
MSA,2021-Q3,105,62,43,Positive
PK,2021-Q2,125,39,86,Positive
BUD,2022-Q1,134,44,90,Positive
LUMN,2022-Q4,110,63,47,Positive
NNN,2021-Q3,53,38,15,Positive
PLTR,2022-Q1,64,90,-26,Negative
RBLX,2022-Q3,62,34,28,Positive
RHP,2021-Q3,93,58,35,Positive
BFH,2021-Q3,109,47,62,Positive
IIPR,2022-Q1,54,27,27,Positive
CCI,2021-Q4,80,30,50,Positive
KODK,2021-Q4,45,15,30,Positive
CAL,2021-Q2,127,45,82,Positive
CCI,2021-Q3,79,30,49,Positive
HUBS,2021-Q3,114,40,74,Positive
AOMR,2022-Q2,59,43,16,Positive
OHI,2022-Q1,40,75,-35,Negative
FSM,2021-Q2,44,59,-15,Negative
KMPR,2022-Q2,96,84,12,Positive
RH,2022-Q3,75,68,7,Positive
REZI,2021-Q2,102,48,54,Positive
HE,2022-Q1,81,53,28,Positive
MTW,2022-Q2,86,91,-5,Negative
FSLY,2021-Q3,85,45,40,Positive
MAIN,2022-Q2,98,21,77,Positive
PFE,2022-Q2,89,57,32,Positive
DASH,2022-Q2,97,59,38,Positive
NNN,2021-Q2,73,50,23,Positive
EXR,2021-Q2,72,59,13,Positive
EAT,2022-Q4,131,44,87,Positive
CNC,2022-Q3,104,67,37,Positive
AZEK,2022-Q2,101,39,62,Positive
ESTC,2023-Q1,125,48,77,Positive
ACEL,2021-Q2,91,34,57,Positive
ASPN,2021-Q2,91,49,42,Positive
RES,2021-Q2,53,51,2,Positive
DG,2022-Q2,154,21,133,Positive
ABEV,2021-Q4,127,44,83,Positive
M,2021-Q2,155,31,124,Positive
NLY,2022-Q1,81,67,14,Positive
OHI,2022-Q4,37,82,-45,Negative
GEL,2021-Q3,50,38,12,Positive
HUBS,2021-Q2,137,32,105,Positive
NTST,2022-Q1,66,31,35,Positive
MFC,2021-Q2,173,55,118,Positive
HNI,2021-Q2,88,37,51,Positive
MUR,2021-Q2,132,44,88,Positive
MCS,2021-Q2,102,45,57,Positive
COR,2021-Q3,90,34,56,Positive
MDT,2023-Q1,117,68,49,Positive
DXC,2022-Q4,125,70,55,Positive
HBM,2021-Q3,64,35,29,Positive
HE,2022-Q2,72,49,23,Positive
ELF,2022-Q3,129,34,95,Positive
CTRE,2021-Q3,96,50,46,Positive
OLN,2021-Q4,90,72,18,Positive
AZEK,2022-Q3,111,25,86,Positive
CMI,2021-Q3,89,62,27,Positive
OGE,2021-Q3,81,30,51,Positive
ITGR,2021-Q3,138,31,107,Positive
MA,2021-Q4,93,32,61,Positive
CUBE,2021-Q2,105,66,39,Positive
CMRE,2021-Q3,33,23,10,Positive
APG,2021-Q2,91,58,33,Positive
AMH,2021-Q2,109,55,54,Positive
AMBC,2021-Q3,53,40,13,Positive
EFC,2021-Q2,83,37,46,Positive
HE,2021-Q4,113,47,66,Positive
AOS,2021-Q3,121,28,93,Positive
MD,2021-Q3,79,58,21,Positive
PRO,2021-Q3,120,57,63,Positive
ROL,2021-Q3,72,55,17,Positive
MA,2022-Q3,86,30,56,Positive
BFAM,2021-Q4,88,50,38,Positive
FICO,2021-Q4,60,57,3,Positive
MLNK,2022-Q2,122,52,70,Positive
POST,2021-Q4,91,85,6,Positive
EVR,2021-Q2,92,34,58,Positive
PEB,2021-Q2,136,36,100,Positive
EAF,2022-Q2,63,56,7,Positive
OLO,2022-Q1,112,34,78,Positive
BSM,2021-Q2,61,26,35,Positive
CVNA,2021-Q3,98,41,57,Positive
GHM,2023-Q1,123,38,85,Positive
BOX,2022-Q2,141,43,98,Positive
MUR,2021-Q4,116,40,76,Positive
MAC,2022-Q2,80,43,37,Positive
MTRN,2021-Q4,124,34,90,Positive
COUR,2021-Q3,105,37,68,Positive
KSS,2021-Q2,178,36,142,Positive
CWK,2022-Q1,119,37,82,Positive
EBR,2021-Q3,46,52,-6,Negative
JELD,2021-Q3,151,64,87,Positive
KR,2021-Q3,114,29,85,Positive
OVV,2021-Q2,147,30,117,Positive
CWK,2021-Q2,123,31,92,Positive
AAT,2021-Q2,92,50,42,Positive
NKE,2022-Q4,122,39,83,Positive
BAX,2021-Q2,85,71,14,Positive
CWT,2021-Q3,51,58,-7,Negative
BBU,2021-Q3,107,62,45,Positive
AM,2022-Q2,39,26,13,Positive
CFG,2021-Q4,167,33,134,Positive
FRO,2021-Q3,48,40,8,Positive
LSPD,2022-Q4,135,44,91,Positive
CFG,2021-Q3,155,31,124,Positive
PSX,2022-Q3,76,70,6,Positive
RBA,2022-Q2,98,37,61,Positive
REVG,2022-Q1,93,74,19,Positive
RLX,2022-Q1,70,42,28,Positive
BRBR,2021-Q4,115,60,55,Positive
FMX,2021-Q3,133,51,82,Positive
GLOB,2021-Q2,116,34,82,Positive
HAYW,2022-Q2,90,46,44,Positive
KMPR,2021-Q2,78,113,-35,Negative
CHX,2021-Q3,114,27,87,Positive
BLD,2021-Q3,107,48,59,Positive
DG,2021-Q2,144,44,100,Positive
RF,2022-Q3,81,71,10,Positive
ROL,2022-Q3,142,53,89,Positive
MTN,2021-Q4,111,61,50,Positive
CLH,2021-Q2,113,35,78,Positive
HWM,2021-Q3,67,48,19,Positive
MAC,2021-Q3,92,45,47,Positive
INSP,2021-Q3,87,46,41,Positive
EB,2021-Q3,122,28,94,Positive
PUMP,2021-Q3,147,49,98,Positive
MCK,2023-Q1,103,58,45,Positive
OHI,2021-Q2,53,79,-26,Negative
CSL,2021-Q3,147,53,94,Positive
APAM,2021-Q2,70,38,32,Positive
EPD,2021-Q2,60,38,22,Positive
NWG,2021-Q2,71,39,32,Positive
CMP,2021-Q2,98,53,45,Positive
BABA,2023-Q2,115,68,47,Positive
FMX,2021-Q2,92,47,45,Positive
KUKE,2021-Q2,82,46,36,Positive
RGS,2022-Q2,113,46,67,Positive
RHP,2021-Q4,75,46,29,Positive
HMC,2022-Q1,52,75,-23,Negative
CNNE,2021-Q3,44,20,24,Positive
EPD,2021-Q3,68,35,33,Positive
MAC,2022-Q4,76,72,4,Positive
FSLY,2022-Q2,100,46,54,Positive
JHX,2022-Q1,150,20,130,Positive
PAYC,2022-Q2,107,61,46,Positive
GM,2021-Q2,108,58,50,Positive
DX,2021-Q3,59,69,-10,Negative
RM,2022-Q2,76,100,-24,Negative
PRU,2022-Q2,114,51,63,Positive
PBR,2021-Q3,87,72,15,Positive
NSP,2021-Q3,98,34,64,Positive
OKE,2022-Q2,79,46,33,Positive
MITT,2021-Q2,69,44,25,Positive
MAC,2022-Q3,84,40,44,Positive
CSAN,2022-Q1,96,66,30,Positive
PSN,2021-Q3,97,45,52,Positive
MLNK,2022-Q1,96,39,57,Positive
MC,2021-Q3,78,46,32,Positive
MMM,2021-Q4,118,76,42,Positive
PLNT,2022-Q3,57,39,18,Positive
BBDC,2022-Q2,67,58,9,Positive
BNED,2022-Q2,104,50,54,Positive
DT,2022-Q3,122,25,97,Positive
NXRT,2021-Q3,61,56,5,Positive
QS,2021-Q3,76,43,33,Positive
MEG,2021-Q3,81,39,42,Positive
KREF,2021-Q4,67,37,30,Positive
AM,2021-Q3,25,26,-1,Negative
GGG,2021-Q3,70,72,-2,Negative
DKL,2021-Q4,20,10,10,Positive
MODG,2021-Q4,112,37,75,Positive
CHMI,2021-Q2,57,40,17,Positive
KUKE,2022-Q1,38,50,-12,Negative
ALLY,2022-Q3,91,54,37,Positive
COTY,2022-Q2,156,21,135,Positive
MFA,2022-Q1,75,81,-6,Negative
KR,2022-Q3,109,46,63,Positive
GEF,2022-Q2,85,62,23,Positive
PAYC,2022-Q3,88,36,52,Positive
CTVA,2021-Q3,126,37,89,Positive
NLY,2021-Q3,93,42,51,Positive
NOV,2021-Q3,122,80,42,Positive
BLND,2022-Q1,102,68,34,Positive
KBH,2021-Q4,125,41,84,Positive
KEY,2021-Q4,86,34,52,Positive
PSX,2021-Q2,79,39,40,Positive
MYE,2021-Q3,123,35,88,Positive
BRX,2021-Q3,107,46,61,Positive
KTB,2021-Q2,141,44,97,Positive
BALL,2021-Q3,76,56,20,Positive
NBHC,2021-Q3,81,38,43,Positive
NX,2022-Q1,75,57,18,Positive
CVEO,2021-Q3,55,43,12,Positive
HCA,2022-Q2,96,43,53,Positive
EQNR,2021-Q3,76,81,-5,Negative
GNW,2022-Q2,97,74,23,Positive
ACI,2021-Q1,95,25,70,Positive
PBF,2021-Q4,83,46,37,Positive
MSM,2021-Q4,76,63,13,Positive
CODI,2021-Q2,110,62,48,Positive
OIS,2021-Q4,33,29,4,Positive
ATR,2021-Q2,70,50,20,Positive
EPAM,2021-Q2,71,28,43,Positive
M,2022-Q3,109,51,58,Positive
AMCR,2021-Q4,105,38,67,Positive
OSCR,2021-Q2,84,38,46,Positive
LUMN,2021-Q4,96,57,39,Positive
PD,2022-Q4,123,60,63,Positive
GTN,2021-Q4,77,37,40,Positive
KTB,2021-Q3,124,32,92,Positive
NFG,2021-Q3,102,32,70,Positive
AZUL,2021-Q2,109,32,77,Positive
NTR,2022-Q2,83,61,22,Positive
PSX,2022-Q2,103,36,67,Positive
PFS,2021-Q4,115,48,67,Positive
CCI,2022-Q2,72,31,41,Positive
BBU,2021-Q2,113,43,70,Positive
CBZ,2021-Q3,101,37,64,Positive
HAYW,2021-Q4,119,22,97,Positive
HAL,2021-Q4,119,21,98,Positive
AQN,2022-Q1,91,47,44,Positive
FTV,2021-Q2,128,35,93,Positive
CPS,2021-Q3,92,72,20,Positive
FIGS,2021-Q3,135,49,86,Positive
BAP,2021-Q3,117,52,65,Positive
LOW,2021-Q3,134,23,111,Positive
ETN,2021-Q3,123,58,65,Positive
FSM,2022-Q2,63,60,3,Positive
MCW,2022-Q1,102,58,44,Positive
GPK,2022-Q2,81,25,56,Positive
ASPN,2022-Q1,83,55,28,Positive
GIS,2022-Q4,60,89,-29,Negative
MAIN,2021-Q2,105,26,79,Positive
DOCS,2022-Q4,78,51,27,Positive
IDT,2022-Q4,86,48,38,Positive
KR,2022-Q2,149,22,127,Positive
O,2021-Q3,81,34,47,Positive
FN,2021-Q4,94,34,60,Positive
IRT,2021-Q3,86,46,40,Positive
MPLX,2021-Q2,76,40,36,Positive
PSTG,2022-Q4,123,56,67,Positive
CNMD,2021-Q3,81,82,-1,Negative
MCK,2022-Q4,130,42,88,Positive
CACI,2021-Q4,92,29,63,Positive
RSG,2021-Q3,97,40,57,Positive
GDDY,2021-Q3,141,24,117,Positive
CVNA,2021-Q2,115,39,76,Positive
AI,2023-Q1,82,58,24,Positive
ARLO,2022-Q1,62,33,29,Positive
PK,2022-Q2,107,47,60,Positive
CXM,2022-Q3,98,35,63,Positive
ABBV,2021-Q4,107,35,72,Positive
MMM,2022-Q1,93,78,15,Positive
LLY,2022-Q1,85,66,19,Positive
DXC,2023-Q1,95,58,37,Positive
MFA,2022-Q2,79,92,-13,Negative
GIS,2022-Q3,83,60,23,Positive
LNN,2021-Q4,63,35,28,Positive
DXC,2023-Q3,97,65,32,Positive
RKT,2021-Q3,130,29,101,Positive
NHI,2021-Q2,72,64,8,Positive
PCOR,2021-Q3,111,61,50,Positive
FNV,2021-Q3,86,37,49,Positive
MDT,2022-Q1,116,49,67,Positive
BAP,2021-Q2,99,71,28,Positive
CIG,2021-Q2,85,45,40,Positive
JNPR,2021-Q3,116,55,61,Positive
IEX,2022-Q1,91,63,28,Positive
CX,2021-Q3,95,49,46,Positive
PFE,2022-Q3,106,53,53,Positive
MA,2021-Q3,118,35,83,Positive
MCK,2023-Q3,113,44,69,Positive
ARMK,2021-Q4,144,25,119,Positive
CNC,2021-Q3,104,44,60,Positive
ATO,2021-Q4,65,25,40,Positive
KODK,2022-Q1,28,17,11,Positive
MA,2022-Q1,100,45,55,Positive
NLY,2022-Q3,65,109,-44,Negative
ACA,2021-Q2,142,51,91,Positive
HRB,2022-Q3,111,27,84,Positive
ESRT,2022-Q1,96,35,61,Positive
AMWL,2021-Q4,94,52,42,Positive
MCD,2021-Q2,144,37,107,Positive
BBY,2023-Q2,75,57,18,Positive
AQN,2021-Q3,104,48,56,Positive
CTVA,2021-Q2,152,26,126,Positive
AZEK,2021-Q3,103,37,66,Positive
RPM,2022-Q4,113,80,33,Positive
CWAN,2021-Q4,86,32,54,Positive
MCW,2021-Q2,89,44,45,Positive
PRA,2021-Q3,100,120,-20,Negative
BHE,2021-Q3,95,56,39,Positive
FRO,2022-Q2,41,49,-8,Negative
AMCR,2022-Q1,82,68,14,Positive
LXP,2021-Q2,86,29,57,Positive
DKL,2021-Q3,23,15,8,Positive
ARCO,2021-Q3,161,33,128,Positive
IDT,2022-Q1,93,48,45,Positive
KR,2021-Q2,118,23,95,Positive
COP,2022-Q4,71,42,29,Positive
CODI,2021-Q4,89,59,30,Positive
APO,2021-Q4,99,43,56,Positive
MAIN,2022-Q1,99,21,78,Positive
MAX,2022-Q1,66,39,27,Positive
RMD,2022-Q3,120,60,60,Positive
NIO,2021-Q2,65,48,17,Positive
LOB,2022-Q4,122,55,67,Positive
ASB,2021-Q3,95,46,49,Positive
AVTR,2021-Q2,122,21,101,Positive
LCII,2022-Q2,151,40,111,Positive
GFL,2022-Q1,97,40,57,Positive
NGVT,2022-Q2,98,43,55,Positive
CVS,2022-Q3,124,51,73,Positive
MAC,2021-Q2,94,48,46,Positive
DNB,2021-Q3,126,20,106,Positive
LHX,2021-Q2,119,48,71,Positive
ICL,2021-Q3,102,48,54,Positive
ANET,2022-Q3,81,49,32,Positive
FSM,2022-Q1,33,29,4,Positive
GTY,2021-Q3,62,34,28,Positive
MKC,2021-Q4,113,30,83,Positive
GCI,2021-Q2,95,22,73,Positive
EPD,2021-Q4,47,42,5,Positive
AGO,2021-Q3,85,50,35,Positive
GM,2021-Q4,104,27,77,Positive
FTS,2021-Q3,68,37,31,Positive
BJ,2022-Q2,130,35,95,Positive
RSKD,2022-Q2,151,59,92,Positive
BJ,2021-Q3,153,41,112,Positive
DASH,2022-Q1,95,63,32,Positive
PUMP,2021-Q2,147,46,101,Positive
GM,2022-Q3,114,31,83,Positive
CPS,2021-Q2,112,82,30,Positive
MATV,2021-Q2,107,49,58,Positive
ADT,2021-Q2,121,43,78,Positive
EVTC,2021-Q3,99,43,56,Positive
CVS,2021-Q2,108,32,76,Positive
LCII,2021-Q3,110,45,65,Positive
EVH,2022-Q3,103,24,79,Positive
PRA,2021-Q2,106,92,14,Positive
DT,2022-Q1,123,30,93,Positive
DIS,2021-Q4,119,34,85,Positive
ARMK,2021-Q3,143,38,105,Positive
AGRO,2021-Q3,97,90,7,Positive
CX,2021-Q2,117,49,68,Positive
OUT,2021-Q2,66,31,35,Positive
RDN,2021-Q3,86,90,-4,Negative
GNE,2021-Q3,53,47,6,Positive
MPLX,2021-Q3,64,31,33,Positive
OSK,2021-Q4,122,59,63,Positive
GBCI,2022-Q2,84,39,45,Positive
DOC,2021-Q3,108,37,71,Positive
AMWL,2021-Q3,123,57,66,Positive
EPAM,2022-Q2,73,42,31,Positive
ARLO,2021-Q3,67,58,9,Positive
ESRT,2022-Q2,113,44,69,Positive
MCS,2021-Q3,95,45,50,Positive
CNMD,2021-Q2,92,58,34,Positive
IDA,2021-Q3,44,41,3,Positive
FUBO,2022-Q1,98,58,40,Positive
MTH,2022-Q1,69,76,-7,Negative
HI,2021-Q4,144,50,94,Positive
CLB,2022-Q2,107,57,50,Positive
FUBO,2021-Q2,133,39,94,Positive
HASI,2021-Q2,74,24,50,Positive
HAYW,2021-Q3,119,38,81,Positive
MAX,2021-Q2,36,38,-2,Negative
DEI,2021-Q4,70,47,23,Positive
HUBS,2021-Q4,108,34,74,Positive
CRI,2021-Q3,139,62,77,Positive
EPD,2022-Q2,54,33,21,Positive
FSLY,2021-Q4,99,48,51,Positive
AAP,2021-Q2,101,56,45,Positive
CXM,2022-Q4,101,48,53,Positive
CAL,2021-Q3,130,47,83,Positive
ARLO,2022-Q2,72,29,43,Positive
COO,2022-Q1,104,67,37,Positive
PRLB,2021-Q4,122,56,66,Positive
MEI,2022-Q1,53,54,-1,Negative
BDC,2021-Q3,126,36,90,Positive
BCC,2021-Q4,86,49,37,Positive
BE,2021-Q3,115,27,88,Positive
ELAN,2021-Q3,98,54,44,Positive
CPS,2022-Q2,131,52,79,Positive
AM,2021-Q4,26,25,1,Positive
RLX,2021-Q3,67,42,25,Positive
ADCT,2021-Q3,83,57,26,Positive
MTZ,2021-Q3,125,41,84,Positive
DOV,2021-Q3,103,73,30,Positive
DAC,2021-Q4,50,23,27,Positive
KUKE,2021-Q3,82,50,32,Positive
RITM,2021-Q4,81,30,51,Positive
NET,2021-Q4,143,34,109,Positive
MTH,2022-Q4,86,76,10,Positive
HD,2021-Q2,141,44,97,Positive
ADCT,2022-Q1,103,42,61,Positive
BEP,2021-Q2,129,31,98,Positive
EAT,2022-Q3,104,49,55,Positive
LUMN,2022-Q1,99,68,31,Positive
GMED,2022-Q3,102,59,43,Positive
GEL,2022-Q1,62,33,29,Positive
CCS,2021-Q2,94,51,43,Positive
RES,2021-Q3,60,55,5,Positive
ESTC,2022-Q2,109,38,71,Positive
AGRO,2021-Q2,84,44,40,Positive
BHC,2021-Q3,86,70,16,Positive
CNS,2022-Q1,94,61,33,Positive
BUD,2022-Q3,112,36,76,Positive
BJ,2021-Q4,162,34,128,Positive
NGVT,2021-Q4,110,48,62,Positive
ROL,2021-Q4,93,71,22,Positive
IIIN,2021-Q4,64,59,5,Positive
LDI,2022-Q1,90,51,39,Positive
EBS,2022-Q1,59,69,-10,Negative
ENS,2022-Q1,91,59,32,Positive
COOK,2021-Q3,114,49,65,Positive
DAC,2021-Q2,57,22,35,Positive
ACI,2021-Q2,101,30,71,Positive
LUMN,2022-Q2,101,86,15,Positive
LZB,2022-Q2,97,64,33,Positive
CARS,2021-Q2,129,39,90,Positive
FCPT,2021-Q2,39,34,5,Positive
KAR,2021-Q3,109,56,53,Positive
INVH,2021-Q3,92,63,29,Positive
CMP,2021-Q1,123,36,87,Positive
DNB,2021-Q2,93,20,73,Positive
MTH,2022-Q2,74,81,-7,Negative
BJ,2022-Q3,136,35,101,Positive
HESM,2021-Q3,59,24,35,Positive
RHP,2021-Q2,87,57,30,Positive
AWR,2021-Q2,38,33,5,Positive
KKR,2021-Q3,102,39,63,Positive
LAW,2022-Q2,81,84,-3,Negative
BBDC,2022-Q1,79,68,11,Positive
LRN,2022-Q1,84,67,17,Positive
LUMN,2021-Q3,106,50,56,Positive
EPRT,2021-Q2,87,41,46,Positive
LTC,2021-Q3,56,43,13,Positive
AMN,2021-Q2,99,40,59,Positive
GRBK,2021-Q3,113,52,61,Positive
MODG,2022-Q2,137,31,106,Positive
MODG,2022-Q3,126,49,77,Positive
COMP,2022-Q3,94,71,23,Positive
AX,2022-Q2,103,40,63,Positive
CIM,2022-Q1,33,32,1,Positive
GFI,2021-Q2,100,58,42,Positive
CSAN,2022-Q2,100,69,31,Positive
BAX,2021-Q2,89,65,24,Positive
EVH,2021-Q3,113,41,72,Positive
APTV,2021-Q2,102,40,62,Positive
COP,2021-Q3,92,45,47,Positive
GHLD,2021-Q3,55,41,14,Positive
CIG,2021-Q4,102,57,45,Positive
CPS,2022-Q1,93,64,29,Positive
AZZ,2023-Q1,83,50,33,Positive
GLW,2022-Q2,145,65,80,Positive
RF,2022-Q4,106,69,37,Positive
FTI,2021-Q4,103,41,62,Positive
PJT,2021-Q3,78,81,-3,Negative
NTR,2021-Q3,107,59,48,Positive
OSCR,2022-Q1,76,30,46,Positive
NOTE,2022-Q2,112,46,66,Positive
NKE,2023-Q2,178,45,133,Positive
ESRT,2021-Q2,65,47,18,Positive
CVEO,2022-Q1,50,30,20,Positive
NVT,2021-Q3,124,37,87,Positive
EL,2022-Q2,155,50,105,Positive
CNC,2021-Q4,113,33,80,Positive
AWR,2021-Q3,30,32,-2,Negative
FSM,2021-Q4,39,51,-12,Negative
APLE,2021-Q2,163,34,129,Positive
MLNK,2021-Q4,95,42,53,Positive
CWAN,2022-Q1,110,42,68,Positive
RBLX,2021-Q2,76,37,39,Positive
CX,2021-Q4,133,42,91,Positive
AQN,2021-Q2,90,45,45,Positive
DIS,2022-Q2,114,44,70,Positive
AHH,2021-Q2,66,36,30,Positive
PD,2023-Q1,142,53,89,Positive
FTS,2022-Q1,68,34,34,Positive
DXC,2022-Q1,128,55,73,Positive
HRB,2022-Q1,101,39,62,Positive
CPNG,2021-Q3,112,68,44,Positive
COTY,2022-Q3,73,36,37,Positive
EAF,2022-Q1,90,39,51,Positive
LSPD,2023-Q3,95,66,29,Positive
PLTR,2022-Q2,56,57,-1,Negative
CWAN,2021-Q3,85,41,44,Positive
CWT,2021-Q2,38,49,-11,Negative
GNRC,2021-Q3,112,33,79,Positive
CC,2021-Q4,138,36,102,Positive
BANC,2021-Q3,133,36,97,Positive
HESM,2022-Q2,53,27,26,Positive
LAW,2021-Q4,104,47,57,Positive
FTS,2022-Q2,57,49,8,Positive
HGV,2021-Q3,135,35,100,Positive
PB,2021-Q3,67,54,13,Positive
LSPD,2022-Q1,134,45,89,Positive
AYI,2021-Q4,127,46,81,Positive
RVLV,2021-Q2,150,28,122,Positive
BBY,2022-Q1,95,49,46,Positive
NOW,2021-Q2,135,33,102,Positive
NTST,2021-Q4,102,34,68,Positive
FOUR,2021-Q4,70,33,37,Positive
DD,2021-Q3,136,48,88,Positive
PRI,2021-Q3,93,78,15,Positive
AYI,2022-Q2,90,48,42,Positive
GFI,2021-Q4,60,49,11,Positive
MFA,2021-Q3,108,67,41,Positive
GDDY,2021-Q4,135,24,111,Positive
BNL,2021-Q4,80,40,40,Positive
CLX,2022-Q1,86,44,42,Positive
LLY,2021-Q2,123,50,73,Positive
CODI,2022-Q1,99,63,36,Positive
RIO,2021-Q2,129,65,64,Positive
ACI,2021-Q3,89,41,48,Positive
MPW,2021-Q3,87,33,54,Positive
CLF,2021-Q3,65,47,18,Positive
ATGE,2022-Q1,83,50,33,Positive
COO,2022-Q2,107,83,24,Positive
MATV,2021-Q3,108,84,24,Positive
ETN,2022-Q1,99,51,48,Positive
CPB,2021-Q4,125,61,64,Positive
LSPD,2022-Q3,129,39,90,Positive
GL,2021-Q3,48,89,-41,Negative
JMIA,2022-Q1,118,33,85,Positive
MFA,2021-Q4,98,80,18,Positive
IMAX,2022-Q3,110,29,81,Positive
MPW,2021-Q4,59,32,27,Positive
PAYC,2022-Q4,77,47,30,Positive
RAMP,2022-Q1,167,30,137,Positive
NIO,2022-Q2,56,48,8,Positive
MKC,2022-Q3,108,74,34,Positive
PFE,2021-Q4,110,35,75,Positive
NOMD,2021-Q3,73,47,26,Positive
CULP,2022-Q1,103,56,47,Positive
GNW,2021-Q3,123,63,60,Positive
PFE,2021-Q2,91,39,52,Positive
PRU,2022-Q3,101,37,64,Positive
IPI,2021-Q4,74,37,37,Positive
GNW,2021-Q4,120,56,64,Positive
PSX,2021-Q3,87,43,44,Positive
LOW,2022-Q1,168,54,114,Positive
PAYC,2021-Q2,127,29,98,Positive
PBF,2021-Q3,65,55,10,Positive
BNL,2022-Q1,67,30,37,Positive
KMT,2022-Q1,118,50,68,Positive
PJT,2021-Q2,73,78,-5,Negative
KR,2022-Q1,121,29,92,Positive
CIM,2021-Q4,67,41,26,Positive
PAR,2022-Q2,120,48,72,Positive
NET,2022-Q1,79,52,27,Positive
GHG,2021-Q3,26,55,-29,Negative
PB,2021-Q2,67,49,18,Positive
EPC,2021-Q4,127,49,78,Positive
AGS,2021-Q3,128,25,103,Positive
DNB,2022-Q2,109,51,58,Positive
RSKD,2021-Q4,110,38,72,Positive
HCA,2022-Q3,81,60,21,Positive
MEG,2022-Q2,80,45,35,Positive
NEXA,2021-Q2,74,53,21,Positive
CX,2022-Q1,110,71,39,Positive
EPC,2021-Q3,123,71,52,Positive
COOK,2021-Q4,103,47,56,Positive
BRX,2021-Q2,125,31,94,Positive
APAM,2022-Q2,54,75,-21,Negative
BROS,2022-Q1,104,41,63,Positive
EAF,2022-Q4,60,67,-7,Negative
INVH,2021-Q2,110,39,71,Positive
CHWY,2021-Q4,89,47,42,Positive
NWG,2022-Q2,102,41,61,Positive
PDM,2022-Q2,98,39,59,Positive
CIO,2021-Q2,53,29,24,Positive
IAG,2021-Q3,62,46,16,Positive
BABA,2022-Q2,83,55,28,Positive
ADM,2022-Q1,108,56,52,Positive
BBY,2022-Q3,81,26,55,Positive
KMT,2021-Q4,136,49,87,Positive
KBH,2022-Q1,80,45,35,Positive
GWRE,2022-Q1,157,60,97,Positive
FOUR,2022-Q2,118,38,80,Positive
LXP,2021-Q3,94,28,66,Positive
HUM,2021-Q2,77,47,30,Positive
MDT,2023-Q2,94,94,0,Neutral
MEG,2021-Q4,108,31,77,Positive
CTRE,2021-Q2,72,57,15,Positive
ELV,2022-Q4,126,47,79,Positive
REXR,2021-Q3,100,33,67,Positive
FNV,2021-Q2,87,50,37,Positive
ABBV,2022-Q2,102,53,49,Positive
RKT,2022-Q1,104,28,76,Positive
GM,2022-Q2,88,58,30,Positive
DVA,2022-Q3,49,98,-49,Negative
NPO,2021-Q3,90,42,48,Positive
APG,2021-Q3,121,51,70,Positive
MMS,2021-Q4,95,47,48,Positive
BAP,2021-Q4,107,68,39,Positive
AI,2022-Q3,73,42,31,Positive
PAY,2022-Q2,59,63,-4,Negative
MEG,2022-Q1,67,31,36,Positive
CC,2022-Q2,63,32,31,Positive
ITT,2021-Q3,140,52,88,Positive
EPD,2022-Q3,55,61,-6,Negative
AGO,2021-Q4,96,61,35,Positive
MUSA,2021-Q2,97,80,17,Positive
KW,2021-Q3,100,27,73,Positive
AX,2022-Q4,88,42,46,Positive
RF,2022-Q1,92,64,28,Positive
PLNT,2022-Q1,62,59,3,Positive
CSTM,2021-Q3,85,47,38,Positive
HMC,2022-Q2,53,94,-41,Negative
OIS,2021-Q2,56,29,27,Positive
FSLY,2022-Q3,168,39,129,Positive
BUD,2021-Q2,125,37,88,Positive
PAR,2021-Q2,105,41,64,Positive
EVH,2022-Q2,97,32,65,Positive
DKL,2021-Q2,21,14,7,Positive
ADCT,2021-Q4,86,62,24,Positive
APG,2022-Q2,132,51,81,Positive
HNI,2021-Q3,99,53,46,Positive
REVG,2021-Q4,109,49,60,Positive
NEXA,2021-Q3,69,63,6,Positive
EL,2022-Q4,166,59,107,Positive
HCA,2021-Q3,83,42,41,Positive
MFA,2021-Q2,105,80,25,Positive
BHE,2021-Q2,113,55,58,Positive
RMD,2022-Q2,119,58,61,Positive
OIS,2022-Q2,61,48,13,Positive
KSS,2022-Q3,104,54,50,Positive
EVTC,2021-Q2,75,23,52,Positive
DNOW,2021-Q3,122,42,80,Positive
MAC,2022-Q1,76,38,38,Positive
KREF,2021-Q3,84,43,41,Positive
RITM,2021-Q2,98,35,63,Positive
AKA,2022-Q1,141,40,101,Positive
OKE,2021-Q2,78,28,50,Positive
RPM,2022-Q1,93,100,-7,Negative
KOS,2021-Q4,86,27,59,Positive
ALV,2021-Q3,65,116,-51,Negative
JMIA,2022-Q3,125,63,62,Positive
ASIX,2021-Q3,107,31,76,Positive
LMND,2022-Q3,66,110,-44,Negative
ICL,2021-Q2,114,65,49,Positive
FUBO,2022-Q3,90,44,46,Positive
GPK,2021-Q2,100,42,58,Positive
AEVA,2021-Q2,146,37,109,Positive
BROS,2022-Q3,110,48,62,Positive
PK,2022-Q1,117,47,70,Positive
EVH,2021-Q4,132,33,99,Positive
OTIS,2021-Q4,94,36,58,Positive
ACI,2022-Q1,90,26,64,Positive
GBX,2022-Q2,115,57,58,Positive
COTY,2022-Q1,182,25,157,Positive
AEVA,2021-Q3,79,47,32,Positive
AZO,2021-Q4,139,32,107,Positive
CCI,2022-Q4,70,32,38,Positive
CIM,2022-Q2,37,39,-2,Negative
ITT,2021-Q2,129,53,76,Positive
CVS,2021-Q4,109,27,82,Positive
AGI,2021-Q2,59,37,22,Positive
PBA,2021-Q3,97,40,57,Positive
NLY,2021-Q2,83,59,24,Positive
MA,2022-Q4,101,26,75,Positive
GPK,2021-Q3,75,52,23,Positive
KMX,2023-Q2,94,73,21,Positive
FRO,2022-Q1,60,71,-11,Negative
FSM,2021-Q3,51,95,-44,Negative
AMRC,2021-Q3,73,60,13,Positive
MSM,2022-Q4,83,60,23,Positive
MAIN,2022-Q3,104,18,86,Positive
PFE,2022-Q4,118,33,85,Positive
FIGS,2022-Q2,133,38,95,Positive
RMD,2021-Q4,81,43,38,Positive
PATH,2022-Q3,113,51,62,Positive
LOB,2022-Q3,111,56,55,Positive
ADM,2022-Q2,143,34,109,Positive
NPO,2022-Q2,83,45,38,Positive
HRI,2021-Q4,128,30,98,Positive
EBS,2021-Q4,103,41,62,Positive
EGP,2021-Q2,99,39,60,Positive
RNG,2022-Q3,134,48,86,Positive
DIS,2022-Q1,96,38,58,Positive
GBX,2021-Q4,126,63,63,Positive
PAY,2021-Q3,105,25,80,Positive
ROL,2022-Q2,110,31,79,Positive
IBP,2021-Q3,101,74,27,Positive
AM,2021-Q2,42,34,8,Positive
CBT,2022-Q1,132,30,102,Positive
CNR,2021-Q2,180,37,143,Positive
OMF,2021-Q3,106,64,42,Positive
LOB,2022-Q1,108,28,80,Positive
RSG,2021-Q2,99,24,75,Positive
EL,2022-Q3,161,60,101,Positive
EAT,2022-Q1,78,39,39,Positive
IEX,2022-Q2,91,47,44,Positive
CYH,2021-Q2,94,35,59,Positive
GMS,2022-Q2,108,59,49,Positive
GTN,2021-Q3,74,40,34,Positive
LC,2021-Q3,110,37,73,Positive
OR,2021-Q2,99,48,51,Positive
BMA,2021-Q2,17,22,-5,Negative
ADCT,2021-Q2,70,49,21,Positive
AZZ,2022-Q3,89,43,46,Positive
GIS,2023-Q1,74,82,-8,Negative
PD,2022-Q3,129,54,75,Positive
AMWL,2022-Q1,125,45,80,Positive
NEU,2021-Q2,8,3,5,Positive
BBY,2022-Q2,83,32,51,Positive
PNNT,2021-Q3,74,46,28,Positive
HCA,2021-Q4,64,54,10,Positive
PFGC,2021-Q4,113,52,61,Positive
HI,2021-Q2,64,42,22,Positive
EHC,2021-Q2,71,46,25,Positive
RNR,2021-Q3,96,133,-37,Negative
DVA,2021-Q4,44,57,-13,Negative
NRG,2021-Q3,81,52,29,Positive
COMP,2021-Q2,140,35,105,Positive
COP,2021-Q2,79,55,24,Positive
BLND,2021-Q3,67,33,34,Positive
NTR,2021-Q4,114,60,54,Positive
MTG,2021-Q2,74,107,-33,Negative
HASI,2021-Q3,84,48,36,Positive
DNB,2021-Q4,105,32,73,Positive
PINS,2021-Q2,65,45,20,Positive
GHLD,2022-Q1,68,36,32,Positive
GNW,2022-Q1,120,87,33,Positive
MTW,2022-Q1,72,98,-26,Negative
BLCO,2022-Q2,103,44,59,Positive
AZUL,2021-Q3,125,33,92,Positive
HAL,2022-Q4,104,35,69,Positive
CC,2022-Q3,72,66,6,Positive
EAF,2021-Q3,84,40,44,Positive
OLO,2021-Q2,88,52,36,Positive
DD,2022-Q1,117,51,66,Positive
CPNG,2022-Q1,149,50,99,Positive
COO,2022-Q3,130,68,62,Positive
MMS,2021-Q3,97,50,47,Positive
CARR,2021-Q2,107,32,75,Positive
LDOS,2021-Q3,88,56,32,Positive
AZEK,2022-Q1,126,27,99,Positive
PARR,2021-Q3,86,42,44,Positive
CHWY,2021-Q2,109,31,78,Positive
CLX,2021-Q4,141,39,102,Positive
BLND,2022-Q2,93,69,24,Positive
PRU,2021-Q4,104,37,67,Positive
RBLX,2021-Q3,68,55,13,Positive
IHG,2021-Q3,87,55,32,Positive
PINS,2022-Q3,102,24,78,Positive
ANET,2022-Q1,62,46,16,Positive
EL,2022-Q1,173,51,122,Positive
LCII,2022-Q1,121,39,82,Positive
COTY,2021-Q4,164,17,147,Positive
CPNG,2021-Q4,119,76,43,Positive
MTX,2021-Q4,121,53,68,Positive
MTRN,2022-Q2,129,34,95,Positive
MTX,2021-Q2,130,32,98,Positive
RAMP,2022-Q2,137,36,101,Positive
FTS,2021-Q4,71,41,30,Positive
CXM,2023-Q1,98,66,32,Positive
ELV,2022-Q3,143,49,94,Positive
ALLY,2021-Q4,148,41,107,Positive
JMIA,2022-Q2,80,40,40,Positive
HOUS,2021-Q2,136,44,92,Positive
MKL,2022-Q4,124,102,22,Positive
CIG,2021-Q3,97,59,38,Positive
BROS,2022-Q2,96,53,43,Positive
GTN,2022-Q2,86,29,57,Positive
EVH,2021-Q2,139,28,111,Positive
NET,2022-Q2,98,68,30,Positive
NVGS,2022-Q1,70,29,41,Positive
GBX,2022-Q1,112,49,63,Positive
LBRT,2022-Q2,92,61,31,Positive
RGS,2022-Q4,96,60,36,Positive
AGL,2021-Q3,106,31,75,Positive
OKE,2021-Q4,61,32,29,Positive
PAYC,2021-Q4,116,32,84,Positive
RPM,2022-Q2,116,96,20,Positive
CACI,2022-Q1,81,52,29,Positive
GTES,2021-Q2,141,59,82,Positive
FNB,2021-Q3,100,27,73,Positive
FIGS,2021-Q2,105,23,82,Positive
CVEO,2021-Q2,50,31,19,Positive
ALLY,2022-Q2,101,58,43,Positive
FUBO,2021-Q4,117,47,70,Positive
BUD,2021-Q4,112,40,72,Positive
GWRE,2021-Q4,117,40,77,Positive
MMC,2021-Q3,98,61,37,Positive
GES,2022-Q3,138,48,90,Positive
AGL,2021-Q4,107,29,78,Positive
RGS,2022-Q3,88,60,28,Positive
CIG,2022-Q1,123,43,80,Positive
MSA,2021-Q2,138,52,86,Positive
BNED,2022-Q1,126,35,91,Positive
PAY,2022-Q1,83,41,42,Positive
PARR,2021-Q2,88,52,36,Positive
EAF,2021-Q4,90,34,56,Positive
HAL,2022-Q3,120,24,96,Positive
BDX,2021-Q3,142,22,120,Positive
CLH,2019-Q3,81,55,26,Positive
ADT,2021-Q3,128,40,88,Positive
CPRI,2022-Q2,121,35,86,Positive
NTR,2022-Q1,65,76,-11,Negative
APG,2021-Q4,126,51,75,Positive
CWEN,2021-Q4,62,44,18,Positive
PRU,2021-Q3,106,49,57,Positive
AAP,2021-Q3,105,43,62,Positive
KN,2021-Q2,80,32,48,Positive
LOW,2022-Q3,149,46,103,Positive
CLB,2022-Q1,89,67,22,Positive
AAT,2021-Q3,83,60,23,Positive
ESTC,2022-Q1,113,56,57,Positive
BDC,2021-Q2,105,21,84,Positive
APLE,2021-Q4,123,44,79,Positive
COP,2022-Q1,62,56,6,Positive
NTST,2022-Q2,67,50,17,Positive
ARES,2021-Q3,96,21,75,Positive
GNE,2021-Q2,69,25,44,Positive
GBCI,2021-Q4,103,43,60,Positive
MGY,2021-Q3,83,57,26,Positive
PSTG,2022-Q2,131,37,94,Positive
FIX,2021-Q2,117,46,71,Positive
AQN,2022-Q3,84,50,34,Positive
LCII,2021-Q4,129,36,93,Positive
RS,2021-Q3,110,58,52,Positive
MTG,2021-Q3,78,100,-22,Negative
BV,2022-Q3,150,21,129,Positive
HD,2021-Q3,141,40,101,Positive
OFG,2021-Q3,91,49,42,Positive
ESRT,2021-Q3,82,38,44,Positive
PNW,2021-Q3,95,52,43,Positive
ALE,2022-Q1,49,22,27,Positive
KAR,2021-Q2,114,55,59,Positive
MMC,2021-Q4,129,41,88,Positive
MDT,2022-Q2,137,68,69,Positive
CNC,2022-Q2,102,33,69,Positive
ADM,2021-Q3,115,33,82,Positive
CABO,2021-Q3,71,33,38,Positive
MTN,2022-Q2,83,48,35,Positive
NGVT,2021-Q3,84,65,19,Positive
KREF,2022-Q1,74,43,31,Positive
BUD,2021-Q3,111,54,57,Positive
MKL,2021-Q2,116,67,49,Positive
BXP,2021-Q3,56,38,18,Positive
DT,2022-Q4,86,37,49,Positive
JMIA,2021-Q2,76,27,49,Positive
FTI,2022-Q1,86,42,44,Positive
GTN,2021-Q2,73,49,24,Positive
MMC,2022-Q2,97,84,13,Positive
REX,2021-Q3,58,31,27,Positive
LBRT,2021-Q3,133,62,71,Positive
HPP,2021-Q2,67,42,25,Positive
ELAN,2021-Q2,100,53,47,Positive
FOUR,2021-Q2,83,43,40,Positive
KMX,2023-Q1,129,65,64,Positive
NHI,2021-Q3,68,45,23,Positive
ONTO,2021-Q2,101,40,61,Positive
J,2021-Q4,92,41,51,Positive
IDA,2021-Q2,51,45,6,Positive
NKE,2022-Q1,147,61,86,Positive
MMM,2022-Q4,92,101,-9,Negative
BBDC,2021-Q3,54,58,-4,Negative
CXW,2021-Q2,67,66,1,Positive
IBP,2021-Q2,103,58,45,Positive
MTRN,2021-Q2,127,27,100,Positive
RF,2021-Q4,105,56,49,Positive
GTN,2022-Q1,100,31,69,Positive
DIS,2022-Q3,116,31,85,Positive
FSLY,2022-Q1,77,49,28,Positive
HAL,2021-Q3,116,32,84,Positive
NIO,2022-Q3,75,56,19,Positive
LSPD,2023-Q2,90,56,34,Positive
CHMI,2021-Q3,35,45,-10,Negative
BFAM,2021-Q3,84,57,27,Positive
GBX,2022-Q3,95,43,52,Positive
COP,2022-Q3,77,38,39,Positive
CUBI,2021-Q3,107,23,84,Positive
MKC,2021-Q3,103,47,56,Positive
DEI,2022-Q2,70,63,7,Positive
GHM,2022-Q4,130,51,79,Positive
LMND,2021-Q2,89,78,11,Positive
NKE,2023-Q1,167,41,126,Positive
COOK,2022-Q1,101,49,52,Positive
IPI,2022-Q2,72,46,26,Positive
O,2022-Q1,70,39,31,Positive
GHM,2022-Q3,79,86,-7,Negative
ETN,2022-Q2,100,62,38,Positive
BXP,2021-Q2,69,24,45,Positive
MP,2021-Q3,100,53,47,Positive
IIPR,2022-Q2,87,61,26,Positive
ADNT,2021-Q3,71,114,-43,Negative
CWEN,2022-Q3,58,61,-3,Negative
LMND,2022-Q1,68,125,-57,Negative
HUBS,2022-Q3,106,37,69,Positive
RBLX,2022-Q1,92,42,50,Positive
ELF,2022-Q2,104,44,60,Positive
EFC,2021-Q3,96,51,45,Positive
HAL,2022-Q2,134,44,90,Positive
ELAN,2022-Q3,139,82,57,Positive
KSS,2021-Q3,138,37,101,Positive
MOH,2021-Q2,65,54,11,Positive
MTN,2022-Q3,100,42,58,Positive
CBT,2022-Q3,108,42,66,Positive
LLY,2022-Q4,84,55,29,Positive
MTRN,2021-Q3,105,43,62,Positive
ORI,2021-Q3,79,45,34,Positive
CE,2021-Q3,56,73,-17,Negative
KOS,2021-Q2,65,36,29,Positive
DG,2021-Q3,130,45,85,Positive
GNW,2022-Q4,132,55,77,Positive
NWG,2022-Q1,84,43,41,Positive
GMS,2022-Q1,110,49,61,Positive
MAIN,2021-Q3,119,26,93,Positive
CX,2022-Q2,99,90,9,Positive
REVG,2021-Q3,104,67,37,Positive
IEX,2021-Q4,102,72,30,Positive
HMC,2023-Q2,42,106,-64,Negative
CPRI,2022-Q1,121,34,87,Positive
IMAX,2021-Q4,123,20,103,Positive
DFIN,2021-Q3,115,32,83,Positive
DRH,2021-Q2,156,25,131,Positive
PSX,2022-Q1,70,29,41,Positive
HGV,2021-Q2,109,40,69,Positive
NLY,2022-Q2,89,94,-5,Negative
RNG,2022-Q1,132,37,95,Positive
IR,2022-Q1,132,34,98,Positive
RBLX,2021-Q4,70,45,25,Positive
CXM,2023-Q2,95,46,49,Positive
PNNT,2022-Q3,54,63,-9,Negative
PFGC,2022-Q1,136,43,93,Positive
MITT,2022-Q2,43,51,-8,Negative
RNG,2022-Q2,136,31,105,Positive
KSS,2022-Q1,115,42,73,Positive
CPB,2022-Q1,112,53,59,Positive
MTH,2021-Q3,96,75,21,Positive
AGRO,2021-Q3,101,32,69,Positive
DBI,2022-Q2,101,27,74,Positive
GIS,2022-Q2,104,91,13,Positive
FUBO,2022-Q2,86,57,29,Positive
EBS,2022-Q3,82,91,-9,Negative
CNS,2021-Q4,103,47,56,Positive
AKA,2022-Q2,135,27,108,Positive
NOW,2022-Q2,110,36,74,Positive
MD,2021-Q2,81,37,44,Positive
RPM,2022-Q3,86,87,-1,Negative
M,2022-Q1,108,31,77,Positive
LTC,2021-Q2,73,52,21,Positive
AQN,2022-Q2,100,41,59,Positive
O,2022-Q3,82,49,33,Positive
MTDR,2021-Q2,119,26,93,Positive
DVA,2021-Q3,64,50,14,Positive
PD,2023-Q2,134,97,37,Positive
